College Code,College Name,Branch Code,Branch Name,2023,2024,Difference
1,University Departments of Anna University  Chennai -CEG Campus  Sardar Patel Road  Guindy  Chennai 600025,BY,BIO MEDICAL ENGINEERING(SS),53,53,0
1,University Departments of Anna University  Chennai -CEG Campus  Sardar Patel Road  Guindy  Chennai 600025,CE,CIVIL  ENGINEERING,53,53,0
1,University Departments of Anna University  Chennai -CEG Campus  Sardar Patel Road  Guindy  Chennai 600025,CM,COMPUTER SCIENCE ANDENGINEERING (SS),101,107,6
1,University Departments of Anna University  Chennai -CEG Campus  Sardar Patel Road  Guindy  Chennai 600025,CS,COMPUTER SCIENCE ANDENGINEERING,51,54,3
1,University Departments of Anna University  Chennai -CEG Campus  Sardar Patel Road  Guindy  Chennai 600025,EC,ELECTRONICS ANDCOMMUNICATIONENGINEERING,51,54,3
1,University Departments of Anna University  Chennai -CEG Campus  Sardar Patel Road  Guindy  Chennai 600025,EE,ELECTRICAL AND ELECTRONICSENGINEERING,51,54,3
1,University Departments of Anna University  Chennai -CEG Campus  Sardar Patel Road  Guindy  Chennai 600025,EL,Electronics Engineering (VLSIDesign and Technology) (SS),0,27,27
1,University Departments of Anna University  Chennai -CEG Campus  Sardar Patel Road  Guindy  Chennai 600025,EM,ELECTRONICS ANDCOMMUNICATIONENGINEERING (SS),53,53,0
1,University Departments of Anna University  Chennai -CEG Campus  Sardar Patel Road  Guindy  Chennai 600025,GI,GEO INFORMATICS,53,54,1
1,University Departments of Anna University  Chennai -CEG Campus  Sardar Patel Road  Guindy  Chennai 600025,IE,INDUSTRIAL ENGINEERING,52,53,1
1,University Departments of Anna University  Chennai -CEG Campus  Sardar Patel Road  Guindy  Chennai 600025,IM,INFORMATION TECHNOLOGY(SS),102,106,4
1,University Departments of Anna University  Chennai -CEG Campus  Sardar Patel Road  Guindy  Chennai 600025,MA,MATERIAL SCIENCE ANDENGINEERING (SS),26,26,0
1,University Departments of Anna University  Chennai -CEG Campus  Sardar Patel Road  Guindy  Chennai 600025,ME,MECHANICAL ENGINEERING,106,107,1
1,University Departments of Anna University  Chennai -CEG Campus  Sardar Patel Road  Guindy  Chennai 600025,MI,MINING ENGINEERING,26,26,0
1,University Departments of Anna University  Chennai -CEG Campus  Sardar Patel Road  Guindy  Chennai 600025,MN,MANUFACTURINGENGINEERING,53,53,0
1,University Departments of Anna University  Chennai -CEG Campus  Sardar Patel Road  Guindy  Chennai 600025,PT,PRINTING & PACKINGTECHNOLOGY,54,53,-1
1,University Departments of Anna University  Chennai -CEG Campus  Sardar Patel Road  Guindy  Chennai 600025,XC,CIVIL ENGINEERING (TAMILMEDIUM),27,27,0
1,University Departments of Anna University  Chennai -CEG Campus  Sardar Patel Road  Guindy  Chennai 600025,XM,MECHANICAL ENGINEERING(TAMIL MEDIUM),27,27,0
2,University Departments of Anna University  Chennai -ACT Campus  Sardar Patel Road  Guindy  Chennai 600025,AP,APPAREL TECHNOLOGY (SS),26,27,1
2,University Departments of Anna University  Chennai -ACT Campus  Sardar Patel Road  Guindy  Chennai 600025,CH,CHEMICAL  ENGINEERING,51,53,2
2,University Departments of Anna University  Chennai -ACT Campus  Sardar Patel Road  Guindy  Chennai 600025,CL,CHEMICAL  ENGINEERING (SS),53,53,0
2,University Departments of Anna University  Chennai -ACT Campus  Sardar Patel Road  Guindy  Chennai 600025,CR,CERAMIC TECHNOLOGY (SS),54,55,1
2,University Departments of Anna University  Chennai -ACT Campus  Sardar Patel Road  Guindy  Chennai 600025,FS,FOOD TECHNOLOGY (SS),35,35,0
2,University Departments of Anna University  Chennai -ACT Campus  Sardar Patel Road  Guindy  Chennai 600025,IB,INDUSTRIAL BIO TECHNOLOGY,27,27,0
2,University Departments of Anna University  Chennai -ACT Campus  Sardar Patel Road  Guindy  Chennai 600025,IS,INDUSTRIAL BIO TECHNOLOGY(SS),18,18,0
2,University Departments of Anna University  Chennai -ACT Campus  Sardar Patel Road  Guindy  Chennai 600025,LE,LEATHER TECHNOLOGY,54,53,-1
2,University Departments of Anna University  Chennai -ACT Campus  Sardar Patel Road  Guindy  Chennai 600025,PM,PHARMACEUTICALTECHNOLOGY (SS),53,54,1
2,University Departments of Anna University  Chennai -ACT Campus  Sardar Patel Road  Guindy  Chennai 600025,PP,PETROLEUM ENGINEERINGAND TECHNOLOGY (SS),54,55,1
2,University Departments of Anna University  Chennai -ACT Campus  Sardar Patel Road  Guindy  Chennai 600025,TX,TEXTILE TECHNOLOGY,52,54,2
3,School of Architecture and Planning  Anna UniversityChennai 600025,BP,B.Plan,36,36,0
4,University Departments of Anna University  Chennai -MIT Campus  Chrompet  Tambaram TalukChengalpattu District 600 044,AE,AERONAUTICAL ENGINEERING,52,54,2
4,University Departments of Anna University  Chennai -MIT Campus  Chrompet  Tambaram TalukChengalpattu District 600 044,AT,ARTIFICIAL INTELLIGENCE ANDDATA SCIENCE (SS),53,54,1
4,University Departments of Anna University  Chennai -MIT Campus  Chrompet  Tambaram TalukChengalpattu District 600 044,AU,AUTOMOBILE ENGINEERING,54,53,-1
4,University Departments of Anna University  Chennai -MIT Campus  Chrompet  Tambaram TalukChengalpattu District 600 044,CM,COMPUTER SCIENCE ANDENGINEERING (SS),52,53,1
4,University Departments of Anna University  Chennai -MIT Campus  Chrompet  Tambaram TalukChengalpattu District 600 044,CS,COMPUTER SCIENCE ANDENGINEERING,51,53,2
4,University Departments of Anna University  Chennai -MIT Campus  Chrompet  Tambaram TalukChengalpattu District 600 044,EC,ELECTRONICS ANDCOMMUNICATIONENGINEERING,50,53,3
4,University Departments of Anna University  Chennai -MIT Campus  Chrompet  Tambaram TalukChengalpattu District 600 044,EI,ELECTRONICS ANDINSTRUMENTATIONENGINEERING,53,54,1
4,University Departments of Anna University  Chennai -MIT Campus  Chrompet  Tambaram TalukChengalpattu District 600 044,EM,ELECTRONICS ANDCOMMUNICATIONENGINEERING (SS),50,53,3
4,University Departments of Anna University  Chennai -MIT Campus  Chrompet  Tambaram TalukChengalpattu District 600 044,IM,INFORMATION TECHNOLOGY(SS),104,107,3
4,University Departments of Anna University  Chennai -MIT Campus  Chrompet  Tambaram TalukChengalpattu District 600 044,PR,PRODUCTION ENGINEERING,52,54,2
4,University Departments of Anna University  Chennai -MIT Campus  Chrompet  Tambaram TalukChengalpattu District 600 044,RA,ROBOTICS AND AUTOMATION(SS),26,26,0
4,University Departments of Anna University  Chennai -MIT Campus  Chrompet  Tambaram TalukChengalpattu District 600 044,RP,RUBBER AND PLASTICTECHNOLOGY,55,55,0
5,Annamalai University Faculty of Engineering andTechnology Annamalai nagar Cuddalore,AM,COMPUTER SCIENCE ANDENGINEERING (AI ANDMACHINE LEARNING),54,55,1
5,Annamalai University Faculty of Engineering andTechnology Annamalai nagar Cuddalore,CE,CIVIL  ENGINEERING,53,54,1
5,Annamalai University Faculty of Engineering andTechnology Annamalai nagar Cuddalore,CF,COMPUTER SCIENCE ANDENGINEERING (DATA SCIENCE),55,54,-1
5,Annamalai University Faculty of Engineering andTechnology Annamalai nagar Cuddalore,CH,CHEMICAL  ENGINEERING,108,108,0
5,Annamalai University Faculty of Engineering andTechnology Annamalai nagar Cuddalore,CS,COMPUTER SCIENCE ANDENGINEERING,107,109,2
5,Annamalai University Faculty of Engineering andTechnology Annamalai nagar Cuddalore,CZ,CIVIL AND STRUCTUTURALENGINEERING,55,55,0
5,Annamalai University Faculty of Engineering andTechnology Annamalai nagar Cuddalore,EC,ELECTRONICS ANDCOMMUNICATIONENGINEERING,55,55,0
5,Annamalai University Faculty of Engineering andTechnology Annamalai nagar Cuddalore,EE,ELECTRICAL AND ELECTRONICSENGINEERING,109,108,-1
5,Annamalai University Faculty of Engineering andTechnology Annamalai nagar Cuddalore,EI,ELECTRONICS ANDINSTRUMENTATIONENGINEERING,55,55,0
5,Annamalai University Faculty of Engineering andTechnology Annamalai nagar Cuddalore,IT,INFORMATION TECHNOLOGY,107,109,2
5,Annamalai University Faculty of Engineering andTechnology Annamalai nagar Cuddalore,ME,MECHANICAL ENGINEERING,109,108,-1
5,Annamalai University Faculty of Engineering andTechnology Annamalai nagar Cuddalore,MM,MECHANICAL ENGINEERING(MANUFACTURING),54,55,1
1013,University College of Engineering  VillupuramKakuppam  Villupuram District 605103,CS,COMPUTER SCIENCE ANDENGINEERING,53,54,1
1013,University College of Engineering  VillupuramKakuppam  Villupuram District 605103,EC,ELECTRONICS ANDCOMMUNICATIONENGINEERING,55,55,0
1013,University College of Engineering  VillupuramKakuppam  Villupuram District 605103,IT,INFORMATION TECHNOLOGY,54,54,0
1013,University College of Engineering  VillupuramKakuppam  Villupuram District 605103,ME,MECHANICAL ENGINEERING,54,55,1
1013,University College of Engineering  VillupuramKakuppam  Villupuram District 605103,XM,MECHANICAL ENGINEERING(TAMIL MEDIUM),27,27,0
1014,University College of Engineering  TindivanamMelpakkam  Tindivanam  Villupuram District 604001,CE,CIVIL  ENGINEERING,55,54,-1
1014,University College of Engineering  TindivanamMelpakkam  Tindivanam  Villupuram District 604001,CS,COMPUTER SCIENCE ANDENGINEERING,53,54,1
1014,University College of Engineering  TindivanamMelpakkam  Tindivanam  Villupuram District 604001,EC,ELECTRONICS ANDCOMMUNICATIONENGINEERING,54,55,1
1014,University College of Engineering  TindivanamMelpakkam  Tindivanam  Villupuram District 604001,IT,INFORMATION TECHNOLOGY,54,54,0
1014,University College of Engineering  TindivanamMelpakkam  Tindivanam  Villupuram District 604001,XC,CIVIL ENGINEERING (TAMILMEDIUM),27,27,0
1015,University College of Engineering  Arni  Arni toDevikapuram Road  Thatchur  Arni  ThiruvannamalaiDistrict 632326,CS,COMPUTER SCIENCE ANDENGINEERING,51,55,4
1015,University College of Engineering  Arni  Arni toDevikapuram Road  Thatchur  Arni  ThiruvannamalaiDistrict 632326,EC,ELECTRONICS ANDCOMMUNICATIONENGINEERING,55,54,-1
1015,University College of Engineering  Arni  Arni toDevikapuram Road  Thatchur  Arni  ThiruvannamalaiDistrict 632326,EE,ELECTRICAL AND ELECTRONICSENGINEERING,54,54,0
1015,University College of Engineering  Arni  Arni toDevikapuram Road  Thatchur  Arni  ThiruvannamalaiDistrict 632326,ME,MECHANICAL ENGINEERING,54,27,-27
1015,University College of Engineering  Arni  Arni toDevikapuram Road  Thatchur  Arni  ThiruvannamalaiDistrict 632326,XM,MECHANICAL ENGINEERING(TAMIL MEDIUM),27,28,1
1026,University College of Engineering  KancheepuramPonnerikarai Campus  NH4  Chennai-BangaloreHighway  Karaipettai Village & Post  KancheepuramDistrict 631552,CS,COMPUTER SCIENCE ANDENGINEERING,55,54,-1
1026,University College of Engineering  KancheepuramPonnerikarai Campus  NH4  Chennai-BangaloreHighway  Karaipettai Village & Post  KancheepuramDistrict 631552,EC,ELECTRONICS ANDCOMMUNICATIONENGINEERING,54,53,-1
1026,University College of Engineering  KancheepuramPonnerikarai Campus  NH4  Chennai-BangaloreHighway  Karaipettai Village & Post  KancheepuramDistrict 631552,EE,ELECTRICAL AND ELECTRONICSENGINEERING,54,55,1
1026,University College of Engineering  KancheepuramPonnerikarai Campus  NH4  Chennai-BangaloreHighway  Karaipettai Village & Post  KancheepuramDistrict 631552,ME,MECHANICAL ENGINEERING,53,55,2
1101,"Aalim Muhammed Salegh College of Engineering,Nizara Educational Campus Muthapudupet, Avadi -IAF, Chennai-600055.",AD,Artificial Intelligence and DataScience,28,27,-1
1101,"Aalim Muhammed Salegh College of Engineering,Nizara Educational Campus Muthapudupet, Avadi -IAF, Chennai-600055.",AM,COMPUTER SCIENCE ANDENGINEERING (AI ANDMACHINE LEARNING),0,14,14
1101,"Aalim Muhammed Salegh College of Engineering,Nizara Educational Campus Muthapudupet, Avadi -IAF, Chennai-600055.",CB,COMPUTER SCIENCE ANDBUSSINESS SYSTEM,0,22,22
1101,"Aalim Muhammed Salegh College of Engineering,Nizara Educational Campus Muthapudupet, Avadi -IAF, Chennai-600055.",CS,COMPUTER SCIENCE ANDENGINEERING,54,54,0
1101,"Aalim Muhammed Salegh College of Engineering,Nizara Educational Campus Muthapudupet, Avadi -IAF, Chennai-600055.",EC,ELECTRONICS ANDCOMMUNICATIONENGINEERING,26,27,1
1101,"Aalim Muhammed Salegh College of Engineering,Nizara Educational Campus Muthapudupet, Avadi -IAF, Chennai-600055.",EE,ELECTRICAL AND ELECTRONICSENGINEERING,23,23,0
1101,"Aalim Muhammed Salegh College of Engineering,Nizara Educational Campus Muthapudupet, Avadi -IAF, Chennai-600055.",IT,INFORMATION TECHNOLOGY,27,27,0
1101,"Aalim Muhammed Salegh College of Engineering,Nizara Educational Campus Muthapudupet, Avadi -IAF, Chennai-600055.",ME,MECHANICAL ENGINEERING,22,18,-4
1101,"Aalim Muhammed Salegh College of Engineering,Nizara Educational Campus Muthapudupet, Avadi -IAF, Chennai-600055.",SC,Computer Science andEngineering (Cyber Security),0,41,41
1102,"Bhajarang Engineering College, Ayathur Village,Veppampattu (R.S), Thiruvallur dist-602024.",CE,CIVIL  ENGINEERING,0,27,27
1102,"Bhajarang Engineering College, Ayathur Village,Veppampattu (R.S), Thiruvallur dist-602024.",CS,COMPUTER SCIENCE ANDENGINEERING,0,28,28
1102,"Bhajarang Engineering College, Ayathur Village,Veppampattu (R.S), Thiruvallur dist-602024.",EC,ELECTRONICS ANDCOMMUNICATIONENGINEERING,0,28,28
1102,"Bhajarang Engineering College, Ayathur Village,Veppampattu (R.S), Thiruvallur dist-602024.",EE,ELECTRICAL AND ELECTRONICSENGINEERING,0,27,27
1102,"Bhajarang Engineering College, Ayathur Village,Veppampattu (R.S), Thiruvallur dist-602024.",ME,MECHANICAL ENGINEERING,0,26,26
1106,"Jaya Engineering College, Prakash Nagar,Thiruninravur, Thiruvallur District, Chennai-602024.",AE,AERONAUTICAL ENGINEERING,27,18,-9
1106,"Jaya Engineering College, Prakash Nagar,Thiruninravur, Thiruvallur District, Chennai-602024.",AM,COMPUTER SCIENCE ANDENGINEERING (AI ANDMACHINE LEARNING),0,14,14
1106,"Jaya Engineering College, Prakash Nagar,Thiruninravur, Thiruvallur District, Chennai-602024.",CB,COMPUTER SCIENCE ANDBUSSINESS SYSTEM,18,14,-4
1106,"Jaya Engineering College, Prakash Nagar,Thiruninravur, Thiruvallur District, Chennai-602024.",CE,CIVIL  ENGINEERING,14,14,0
1106,"Jaya Engineering College, Prakash Nagar,Thiruninravur, Thiruvallur District, Chennai-602024.",CO,COMPUTER ANDCOMMUNICATIONENGINEERING,0,13,13
1106,"Jaya Engineering College, Prakash Nagar,Thiruninravur, Thiruvallur District, Chennai-602024.",CS,COMPUTER SCIENCE ANDENGINEERING,54,54,0
1106,"Jaya Engineering College, Prakash Nagar,Thiruninravur, Thiruvallur District, Chennai-602024.",EC,ELECTRONICS ANDCOMMUNICATIONENGINEERING,41,27,-14
1106,"Jaya Engineering College, Prakash Nagar,Thiruninravur, Thiruvallur District, Chennai-602024.",EE,ELECTRICAL AND ELECTRONICSENGINEERING,27,27,0
1106,"Jaya Engineering College, Prakash Nagar,Thiruninravur, Thiruvallur District, Chennai-602024.",EI,ELECTRONICS ANDINSTRUMENTATIONENGINEERING,18,18,0
1106,"Jaya Engineering College, Prakash Nagar,Thiruninravur, Thiruvallur District, Chennai-602024.",IT,INFORMATION TECHNOLOGY,53,54,1
1106,"Jaya Engineering College, Prakash Nagar,Thiruninravur, Thiruvallur District, Chennai-602024.",ME,MECHANICAL ENGINEERING,27,14,-13
1106,"Jaya Engineering College, Prakash Nagar,Thiruninravur, Thiruvallur District, Chennai-602024.",RM,ROBOTICS AND AUTOMATION,0,14,14
1106,"Jaya Engineering College, Prakash Nagar,Thiruninravur, Thiruvallur District, Chennai-602024.",TX,TEXTILE TECHNOLOGY,18,18,0
1107,"Jaya Institute of Technology, Kanchipadi, Thiruvallur-Thiruthani NH Road, Thiruvallur Taluk & District-631204.",CS,COMPUTER SCIENCE ANDENGINEERING,46,23,-23
1107,"Jaya Institute of Technology, Kanchipadi, Thiruvallur-Thiruthani NH Road, Thiruvallur Taluk & District-631204.",EC,ELECTRONICS ANDCOMMUNICATIONENGINEERING,23,24,1
1107,"Jaya Institute of Technology, Kanchipadi, Thiruvallur-Thiruthani NH Road, Thiruvallur Taluk & District-631204.",EE,ELECTRICAL AND ELECTRONICSENGINEERING,22,22,0
1107,"Jaya Institute of Technology, Kanchipadi, Thiruvallur-Thiruthani NH Road, Thiruvallur Taluk & District-631204.",FD,FOOD TECHNOLOGY,37,22,-15
1107,"Jaya Institute of Technology, Kanchipadi, Thiruvallur-Thiruthani NH Road, Thiruvallur Taluk & District-631204.",ME,MECHANICAL ENGINEERING,22,23,1
1110,"Prathyusha Engineering College (Autonomous),Poonamallee-Tiruvallur High Road,Aranvoyalkuppam, Tiruvallur-602025.",AD,Artificial Intelligence and DataScience,53,68,15
1110,"Prathyusha Engineering College (Autonomous),Poonamallee-Tiruvallur High Road,Aranvoyalkuppam, Tiruvallur-602025.",AM,COMPUTER SCIENCE ANDENGINEERING (AI ANDMACHINE LEARNING),28,41,13
1110,"Prathyusha Engineering College (Autonomous),Poonamallee-Tiruvallur High Road,Aranvoyalkuppam, Tiruvallur-602025.",BT,BIO TECHNOLOGY,52,50,-2
1110,"Prathyusha Engineering College (Autonomous),Poonamallee-Tiruvallur High Road,Aranvoyalkuppam, Tiruvallur-602025.",CB,COMPUTER SCIENCE ANDBUSSINESS SYSTEM,0,14,14
1110,"Prathyusha Engineering College (Autonomous),Poonamallee-Tiruvallur High Road,Aranvoyalkuppam, Tiruvallur-602025.",CS,COMPUTER SCIENCE ANDENGINEERING,80,81,1
1110,"Prathyusha Engineering College (Autonomous),Poonamallee-Tiruvallur High Road,Aranvoyalkuppam, Tiruvallur-602025.",EC,ELECTRONICS ANDCOMMUNICATIONENGINEERING,28,50,22
1110,"Prathyusha Engineering College (Autonomous),Poonamallee-Tiruvallur High Road,Aranvoyalkuppam, Tiruvallur-602025.",EE,ELECTRICAL AND ELECTRONICSENGINEERING,22,23,1
1110,"Prathyusha Engineering College (Autonomous),Poonamallee-Tiruvallur High Road,Aranvoyalkuppam, Tiruvallur-602025.",IT,INFORMATION TECHNOLOGY,27,27,0
1110,"Prathyusha Engineering College (Autonomous),Poonamallee-Tiruvallur High Road,Aranvoyalkuppam, Tiruvallur-602025.",ME,MECHANICAL ENGINEERING,0,27,27
1110,"Prathyusha Engineering College (Autonomous),Poonamallee-Tiruvallur High Road,Aranvoyalkuppam, Tiruvallur-602025.",SC,Computer Science andEngineering (Cyber Security),27,27,0
1112,"R.M.D. Engineering College (Autonomous), R.S.M.Nagar, Gummidipoondi Taluk, Kavaraipettai,Thiruvallur-601206.",AL,Artificial Intelligence andMachine Learning,27,27,0
1112,"R.M.D. Engineering College (Autonomous), R.S.M.Nagar, Gummidipoondi Taluk, Kavaraipettai,Thiruvallur-601206.",CB,COMPUTER SCIENCE ANDBUSSINESS SYSTEM,27,27,0
1112,"R.M.D. Engineering College (Autonomous), R.S.M.Nagar, Gummidipoondi Taluk, Kavaraipettai,Thiruvallur-601206.",CS,COMPUTER SCIENCE ANDENGINEERING,108,109,1
1112,"R.M.D. Engineering College (Autonomous), R.S.M.Nagar, Gummidipoondi Taluk, Kavaraipettai,Thiruvallur-601206.",EC,ELECTRONICS ANDCOMMUNICATIONENGINEERING,79,81,2
1112,"R.M.D. Engineering College (Autonomous), R.S.M.Nagar, Gummidipoondi Taluk, Kavaraipettai,Thiruvallur-601206.",IT,INFORMATION TECHNOLOGY,27,55,28
1113,"R.M.K. Engineering College (Autonomous), R.S.M.Nagar, Kavaraipettai, Gummidipoondi Taluk,Thiruvallur-601206.",AD,Artificial Intelligence and DataScience,54,54,0
1113,"R.M.K. Engineering College (Autonomous), R.S.M.Nagar, Kavaraipettai, Gummidipoondi Taluk,Thiruvallur-601206.",CB,COMPUTER SCIENCE ANDBUSSINESS SYSTEM,28,27,-1
1113,"R.M.K. Engineering College (Autonomous), R.S.M.Nagar, Kavaraipettai, Gummidipoondi Taluk,Thiruvallur-601206.",CD,COMPUTER SCIENCE ANDDESIGN,26,28,2
1113,"R.M.K. Engineering College (Autonomous), R.S.M.Nagar, Kavaraipettai, Gummidipoondi Taluk,Thiruvallur-601206.",CE,CIVIL  ENGINEERING,14,14,0
1113,"R.M.K. Engineering College (Autonomous), R.S.M.Nagar, Kavaraipettai, Gummidipoondi Taluk,Thiruvallur-601206.",CS,COMPUTER SCIENCE ANDENGINEERING,108,109,1
1113,"R.M.K. Engineering College (Autonomous), R.S.M.Nagar, Kavaraipettai, Gummidipoondi Taluk,Thiruvallur-601206.",EA,Electronics and Communication(Advanced CommunicationTechnology),27,27,0
1113,"R.M.K. Engineering College (Autonomous), R.S.M.Nagar, Kavaraipettai, Gummidipoondi Taluk,Thiruvallur-601206.",EC,ELECTRONICS ANDCOMMUNICATIONENGINEERING,80,81,1
1113,"R.M.K. Engineering College (Autonomous), R.S.M.Nagar, Kavaraipettai, Gummidipoondi Taluk,Thiruvallur-601206.",EE,ELECTRICAL AND ELECTRONICSENGINEERING,27,26,-1
1113,"R.M.K. Engineering College (Autonomous), R.S.M.Nagar, Kavaraipettai, Gummidipoondi Taluk,Thiruvallur-601206.",EV,Electronics Engineering (VLSIDesign and Technology),27,27,0
1113,"R.M.K. Engineering College (Autonomous), R.S.M.Nagar, Kavaraipettai, Gummidipoondi Taluk,Thiruvallur-601206.",IT,INFORMATION TECHNOLOGY,55,55,0
1113,"R.M.K. Engineering College (Autonomous), R.S.M.Nagar, Kavaraipettai, Gummidipoondi Taluk,Thiruvallur-601206.",ME,MECHANICAL ENGINEERING,14,14,0
1114,"S.A. Engineering College (Autonomous), Poonamallee-Avadi Road, Thiruverkadu Post, Tiruvallur, Chennai-600077.",AD,Artificial Intelligence and DataScience,55,55,0
1114,"S.A. Engineering College (Autonomous), Poonamallee-Avadi Road, Thiruverkadu Post, Tiruvallur, Chennai-600077.",AM,COMPUTER SCIENCE ANDENGINEERING (AI ANDMACHINE LEARNING),28,27,-1
1114,"S.A. Engineering College (Autonomous), Poonamallee-Avadi Road, Thiruverkadu Post, Tiruvallur, Chennai-600077.",CB,COMPUTER SCIENCE ANDBUSSINESS SYSTEM,27,27,0
1114,"S.A. Engineering College (Autonomous), Poonamallee-Avadi Road, Thiruverkadu Post, Tiruvallur, Chennai-600077.",CE,CIVIL  ENGINEERING,14,18,4
1114,"S.A. Engineering College (Autonomous), Poonamallee-Avadi Road, Thiruverkadu Post, Tiruvallur, Chennai-600077.",CS,COMPUTER SCIENCE ANDENGINEERING,81,150,69
1114,"S.A. Engineering College (Autonomous), Poonamallee-Avadi Road, Thiruverkadu Post, Tiruvallur, Chennai-600077.",EC,ELECTRONICS ANDCOMMUNICATIONENGINEERING,81,81,0
1114,"S.A. Engineering College (Autonomous), Poonamallee-Avadi Road, Thiruverkadu Post, Tiruvallur, Chennai-600077.",EE,ELECTRICAL AND ELECTRONICSENGINEERING,81,81,0
1114,"S.A. Engineering College (Autonomous), Poonamallee-Avadi Road, Thiruverkadu Post, Tiruvallur, Chennai-600077.",EV,Electronics Engineering (VLSIDesign and Technology),54,41,-13
1114,"S.A. Engineering College (Autonomous), Poonamallee-Avadi Road, Thiruverkadu Post, Tiruvallur, Chennai-600077.",IT,INFORMATION TECHNOLOGY,27,62,35
1114,"S.A. Engineering College (Autonomous), Poonamallee-Avadi Road, Thiruverkadu Post, Tiruvallur, Chennai-600077.",ME,MECHANICAL ENGINEERING,36,36,0
1114,"S.A. Engineering College (Autonomous), Poonamallee-Avadi Road, Thiruverkadu Post, Tiruvallur, Chennai-600077.",SC,Computer Science andEngineering (Cyber Security),27,33,6
1115,"SriRam Engineering College, Perumalpattu,Veppampattu R.S., Tiruvallur District, Chennai-602024.",AD,Artificial Intelligence and DataScience,28,41,13
1115,"SriRam Engineering College, Perumalpattu,Veppampattu R.S., Tiruvallur District, Chennai-602024.",AM,COMPUTER SCIENCE ANDENGINEERING (AI ANDMACHINE LEARNING),23,22,-1
1115,"SriRam Engineering College, Perumalpattu,Veppampattu R.S., Tiruvallur District, Chennai-602024.",CB,COMPUTER SCIENCE ANDBUSSINESS SYSTEM,22,22,0
1115,"SriRam Engineering College, Perumalpattu,Veppampattu R.S., Tiruvallur District, Chennai-602024.",CS,COMPUTER SCIENCE ANDENGINEERING,35,40,5
1115,"SriRam Engineering College, Perumalpattu,Veppampattu R.S., Tiruvallur District, Chennai-602024.",EC,ELECTRONICS ANDCOMMUNICATIONENGINEERING,22,23,1
1115,"SriRam Engineering College, Perumalpattu,Veppampattu R.S., Tiruvallur District, Chennai-602024.",EE,ELECTRICAL AND ELECTRONICSENGINEERING,23,22,-1
1115,"SriRam Engineering College, Perumalpattu,Veppampattu R.S., Tiruvallur District, Chennai-602024.",ME,MECHANICAL ENGINEERING,22,22,0
1115,"SriRam Engineering College, Perumalpattu,Veppampattu R.S., Tiruvallur District, Chennai-602024.",SC,Computer Science andEngineering (Cyber Security),22,21,-1
1116,"Sri Venkateswara College of Engineering andTechnology, Thirupachur, Thiruvallur Taluk & District-631203.",AD,Artificial Intelligence and DataScience,40,27,-13
1116,"Sri Venkateswara College of Engineering andTechnology, Thirupachur, Thiruvallur Taluk & District-631203.",AM,COMPUTER SCIENCE ANDENGINEERING (AI ANDMACHINE LEARNING),22,14,-8
1116,"Sri Venkateswara College of Engineering andTechnology, Thirupachur, Thiruvallur Taluk & District-631203.",CE,CIVIL  ENGINEERING,25,27,2
1116,"Sri Venkateswara College of Engineering andTechnology, Thirupachur, Thiruvallur Taluk & District-631203.",CS,COMPUTER SCIENCE ANDENGINEERING,31,27,-4
1116,"Sri Venkateswara College of Engineering andTechnology, Thirupachur, Thiruvallur Taluk & District-631203.",EC,ELECTRONICS ANDCOMMUNICATIONENGINEERING,46,54,8
1116,"Sri Venkateswara College of Engineering andTechnology, Thirupachur, Thiruvallur Taluk & District-631203.",EE,ELECTRICAL AND ELECTRONICSENGINEERING,18,27,9
1116,"Sri Venkateswara College of Engineering andTechnology, Thirupachur, Thiruvallur Taluk & District-631203.",IT,INFORMATION TECHNOLOGY,18,14,-4
1116,"Sri Venkateswara College of Engineering andTechnology, Thirupachur, Thiruvallur Taluk & District-631203.",ME,MECHANICAL ENGINEERING,45,54,9
1116,"Sri Venkateswara College of Engineering andTechnology, Thirupachur, Thiruvallur Taluk & District-631203.",SC,Computer Science andEngineering (Cyber Security),23,14,-9
1118,"Vel Tech Multi Tech Dr Rangarajan Dr SakunthalaEngineering College (Autonomous), 42, Veltech Road,Avadi, Morai, Thiruvallur-600062.",AD,Artificial Intelligence and DataScience,55,55,0
1118,"Vel Tech Multi Tech Dr Rangarajan Dr SakunthalaEngineering College (Autonomous), 42, Veltech Road,Avadi, Morai, Thiruvallur-600062.",BM,BIO MEDICAL ENGINEERING,40,41,1
1118,"Vel Tech Multi Tech Dr Rangarajan Dr SakunthalaEngineering College (Autonomous), 42, Veltech Road,Avadi, Morai, Thiruvallur-600062.",CB,COMPUTER SCIENCE ANDBUSSINESS SYSTEM,27,28,1
1118,"Vel Tech Multi Tech Dr Rangarajan Dr SakunthalaEngineering College (Autonomous), 42, Veltech Road,Avadi, Morai, Thiruvallur-600062.",CS,COMPUTER SCIENCE ANDENGINEERING,80,81,1
1118,"Vel Tech Multi Tech Dr Rangarajan Dr SakunthalaEngineering College (Autonomous), 42, Veltech Road,Avadi, Morai, Thiruvallur-600062.",EC,ELECTRONICS ANDCOMMUNICATIONENGINEERING,55,54,-1
1118,"Vel Tech Multi Tech Dr Rangarajan Dr SakunthalaEngineering College (Autonomous), 42, Veltech Road,Avadi, Morai, Thiruvallur-600062.",EE,ELECTRICAL AND ELECTRONICSENGINEERING,31,41,10
1118,"Vel Tech Multi Tech Dr Rangarajan Dr SakunthalaEngineering College (Autonomous), 42, Veltech Road,Avadi, Morai, Thiruvallur-600062.",IT,INFORMATION TECHNOLOGY,54,54,0
1118,"Vel Tech Multi Tech Dr Rangarajan Dr SakunthalaEngineering College (Autonomous), 42, Veltech Road,Avadi, Morai, Thiruvallur-600062.",ME,MECHANICAL ENGINEERING,41,41,0
1118,"Vel Tech Multi Tech Dr Rangarajan Dr SakunthalaEngineering College (Autonomous), 42, Veltech Road,Avadi, Morai, Thiruvallur-600062.",SC,Computer Science andEngineering (Cyber Security),0,27,27
1120,"Velammal Engineering College (Autonomous),Velammal Nagar, Ambattur-Redhills Road, Surapet,Thiruvallur, Chennai-600066.",AD,Artificial Intelligence and DataScience,70,70,0
1120,"Velammal Engineering College (Autonomous),Velammal Nagar, Ambattur-Redhills Road, Surapet,Thiruvallur, Chennai-600066.",AU,AUTOMOBILE ENGINEERING,18,18,0
1120,"Velammal Engineering College (Autonomous),Velammal Nagar, Ambattur-Redhills Road, Surapet,Thiruvallur, Chennai-600066.",CE,CIVIL  ENGINEERING,19,19,0
1120,"Velammal Engineering College (Autonomous),Velammal Nagar, Ambattur-Redhills Road, Surapet,Thiruvallur, Chennai-600066.",CS,COMPUTER SCIENCE ANDENGINEERING,139,141,2
1120,"Velammal Engineering College (Autonomous),Velammal Nagar, Ambattur-Redhills Road, Surapet,Thiruvallur, Chennai-600066.",EC,ELECTRONICS ANDCOMMUNICATIONENGINEERING,106,140,34
1120,"Velammal Engineering College (Autonomous),Velammal Nagar, Ambattur-Redhills Road, Surapet,Thiruvallur, Chennai-600066.",EE,ELECTRICAL AND ELECTRONICSENGINEERING,35,35,0
1120,"Velammal Engineering College (Autonomous),Velammal Nagar, Ambattur-Redhills Road, Surapet,Thiruvallur, Chennai-600066.",EI,ELECTRONICS ANDINSTRUMENTATIONENGINEERING,18,19,1
1120,"Velammal Engineering College (Autonomous),Velammal Nagar, Ambattur-Redhills Road, Surapet,Thiruvallur, Chennai-600066.",IT,INFORMATION TECHNOLOGY,69,70,1
1120,"Velammal Engineering College (Autonomous),Velammal Nagar, Ambattur-Redhills Road, Surapet,Thiruvallur, Chennai-600066.",ME,MECHANICAL ENGINEERING,35,36,1
1120,"Velammal Engineering College (Autonomous),Velammal Nagar, Ambattur-Redhills Road, Surapet,Thiruvallur, Chennai-600066.",SC,Computer Science andEngineering (Cyber Security),35,36,1
1121,"Sri Venkateswara Institute of Science and Technology,Kolundhalur, Thiruvallur Taluk & District-631203.",AD,Artificial Intelligence and DataScience,46,45,-1
1121,"Sri Venkateswara Institute of Science and Technology,Kolundhalur, Thiruvallur Taluk & District-631203.",CE,CIVIL  ENGINEERING,23,27,4
1121,"Sri Venkateswara Institute of Science and Technology,Kolundhalur, Thiruvallur Taluk & District-631203.",CS,COMPUTER SCIENCE ANDENGINEERING,45,54,9
1121,"Sri Venkateswara Institute of Science and Technology,Kolundhalur, Thiruvallur Taluk & District-631203.",EC,ELECTRONICS ANDCOMMUNICATIONENGINEERING,45,55,10
1121,"Sri Venkateswara Institute of Science and Technology,Kolundhalur, Thiruvallur Taluk & District-631203.",EE,ELECTRICAL AND ELECTRONICSENGINEERING,20,28,8
1121,"Sri Venkateswara Institute of Science and Technology,Kolundhalur, Thiruvallur Taluk & District-631203.",ME,MECHANICAL ENGINEERING,46,54,8
1121,"Sri Venkateswara Institute of Science and Technology,Kolundhalur, Thiruvallur Taluk & District-631203.",SC,Computer Science andEngineering (Cyber Security),22,27,5
1122,"Vel Tech High Tech Dr.Rangarajan Dr.SakunthalaEngineering College (Autonomous), No. 60, VeltechRoad, Avadi, Morai, Thiruvallur-600062.",AD,Artificial Intelligence and DataScience,53,81,28
1122,"Vel Tech High Tech Dr.Rangarajan Dr.SakunthalaEngineering College (Autonomous), No. 60, VeltechRoad, Avadi, Morai, Thiruvallur-600062.",AM,COMPUTER SCIENCE ANDENGINEERING (AI ANDMACHINE LEARNING),26,55,29
1122,"Vel Tech High Tech Dr.Rangarajan Dr.SakunthalaEngineering College (Autonomous), No. 60, VeltechRoad, Avadi, Morai, Thiruvallur-600062.",BT,BIO TECHNOLOGY,41,41,0
1122,"Vel Tech High Tech Dr.Rangarajan Dr.SakunthalaEngineering College (Autonomous), No. 60, VeltechRoad, Avadi, Morai, Thiruvallur-600062.",CE,CIVIL  ENGINEERING,23,18,-5
1122,"Vel Tech High Tech Dr.Rangarajan Dr.SakunthalaEngineering College (Autonomous), No. 60, VeltechRoad, Avadi, Morai, Thiruvallur-600062.",CH,CHEMICAL  ENGINEERING,41,41,0
1122,"Vel Tech High Tech Dr.Rangarajan Dr.SakunthalaEngineering College (Autonomous), No. 60, VeltechRoad, Avadi, Morai, Thiruvallur-600062.",CS,COMPUTER SCIENCE ANDENGINEERING,80,82,2
1122,"Vel Tech High Tech Dr.Rangarajan Dr.SakunthalaEngineering College (Autonomous), No. 60, VeltechRoad, Avadi, Morai, Thiruvallur-600062.",EC,ELECTRONICS ANDCOMMUNICATIONENGINEERING,55,54,-1
1122,"Vel Tech High Tech Dr.Rangarajan Dr.SakunthalaEngineering College (Autonomous), No. 60, VeltechRoad, Avadi, Morai, Thiruvallur-600062.",IT,INFORMATION TECHNOLOGY,54,54,0
1122,"Vel Tech High Tech Dr.Rangarajan Dr.SakunthalaEngineering College (Autonomous), No. 60, VeltechRoad, Avadi, Morai, Thiruvallur-600062.",ME,MECHANICAL ENGINEERING,41,41,0
1123,"Gojan School of Business and Technology, 80-FeetRoad, Edapalayam, Red Hills, Thiruvallur, Chennai-600052.",AD,Artificial Intelligence and DataScience,17,17,0
1123,"Gojan School of Business and Technology, 80-FeetRoad, Edapalayam, Red Hills, Thiruvallur, Chennai-600052.",AE,AERONAUTICAL ENGINEERING,18,17,-1
1123,"Gojan School of Business and Technology, 80-FeetRoad, Edapalayam, Red Hills, Thiruvallur, Chennai-600052.",AM,COMPUTER SCIENCE ANDENGINEERING (AI ANDMACHINE LEARNING),18,17,-1
1123,"Gojan School of Business and Technology, 80-FeetRoad, Edapalayam, Red Hills, Thiruvallur, Chennai-600052.",BT,BIO TECHNOLOGY,0,17,17
1123,"Gojan School of Business and Technology, 80-FeetRoad, Edapalayam, Red Hills, Thiruvallur, Chennai-600052.",CB,COMPUTER SCIENCE ANDBUSSINESS SYSTEM,18,18,0
1123,"Gojan School of Business and Technology, 80-FeetRoad, Edapalayam, Red Hills, Thiruvallur, Chennai-600052.",CO,COMPUTER ANDCOMMUNICATIONENGINEERING,18,18,0
1123,"Gojan School of Business and Technology, 80-FeetRoad, Edapalayam, Red Hills, Thiruvallur, Chennai-600052.",CS,COMPUTER SCIENCE ANDENGINEERING,16,18,2
1123,"Gojan School of Business and Technology, 80-FeetRoad, Edapalayam, Red Hills, Thiruvallur, Chennai-600052.",EC,ELECTRONICS ANDCOMMUNICATIONENGINEERING,18,18,0
1123,"Gojan School of Business and Technology, 80-FeetRoad, Edapalayam, Red Hills, Thiruvallur, Chennai-600052.",IT,INFORMATION TECHNOLOGY,18,18,0
1123,"Gojan School of Business and Technology, 80-FeetRoad, Edapalayam, Red Hills, Thiruvallur, Chennai-600052.",MD,MEDICAL ELECTRONICSENGINEERING,18,19,1
1123,"Gojan School of Business and Technology, 80-FeetRoad, Edapalayam, Red Hills, Thiruvallur, Chennai-600052.",MU,MECHANICAL ANDAUTOMATION ENGINEERING,17,17,0
1123,"Gojan School of Business and Technology, 80-FeetRoad, Edapalayam, Red Hills, Thiruvallur, Chennai-600052.",PH,PHARMACEUTICALTECHNOLOGY,17,18,1
1123,"Gojan School of Business and Technology, 80-FeetRoad, Edapalayam, Red Hills, Thiruvallur, Chennai-600052.",RM,ROBOTICS AND AUTOMATION,0,18,18
1123,"Gojan School of Business and Technology, 80-FeetRoad, Edapalayam, Red Hills, Thiruvallur, Chennai-600052.",SC,Computer Science andEngineering (Cyber Security),18,18,0
1124,"SAMS College of Engineering and Technology,82,Panapakkam, Tirupathi Road, Uthukottai Taluk,Thiruvallur District-601102.",AD,Artificial Intelligence and DataScience,17,18,1
1124,"SAMS College of Engineering and Technology,82,Panapakkam, Tirupathi Road, Uthukottai Taluk,Thiruvallur District-601102.",AE,AERONAUTICAL ENGINEERING,17,18,1
1124,"SAMS College of Engineering and Technology,82,Panapakkam, Tirupathi Road, Uthukottai Taluk,Thiruvallur District-601102.",AM,COMPUTER SCIENCE ANDENGINEERING (AI ANDMACHINE LEARNING),17,18,1
1124,"SAMS College of Engineering and Technology,82,Panapakkam, Tirupathi Road, Uthukottai Taluk,Thiruvallur District-601102.",CO,COMPUTER ANDCOMMUNICATIONENGINEERING,18,18,0
1124,"SAMS College of Engineering and Technology,82,Panapakkam, Tirupathi Road, Uthukottai Taluk,Thiruvallur District-601102.",CS,COMPUTER SCIENCE ANDENGINEERING,18,17,-1
1124,"SAMS College of Engineering and Technology,82,Panapakkam, Tirupathi Road, Uthukottai Taluk,Thiruvallur District-601102.",ME,MECHANICAL ENGINEERING,17,17,0
1124,"SAMS College of Engineering and Technology,82,Panapakkam, Tirupathi Road, Uthukottai Taluk,Thiruvallur District-601102.",MR,MARINE ENGINEERING,24,24,0
1124,"SAMS College of Engineering and Technology,82,Panapakkam, Tirupathi Road, Uthukottai Taluk,Thiruvallur District-601102.",SC,Computer Science andEngineering (Cyber Security),18,18,0
1125,"PMR Engineering College, Adayalampattu, Tiruvallur,Chennai-600095.",AD,Artificial Intelligence and DataScience,22,23,1
1125,"PMR Engineering College, Adayalampattu, Tiruvallur,Chennai-600095.",AE,AERONAUTICAL ENGINEERING,24,22,-2
1125,"PMR Engineering College, Adayalampattu, Tiruvallur,Chennai-600095.",CE,CIVIL  ENGINEERING,24,22,-2
1125,"PMR Engineering College, Adayalampattu, Tiruvallur,Chennai-600095.",CS,COMPUTER SCIENCE ANDENGINEERING,23,22,-1
1125,"PMR Engineering College, Adayalampattu, Tiruvallur,Chennai-600095.",EC,ELECTRONICS ANDCOMMUNICATIONENGINEERING,25,23,-2
1125,"PMR Engineering College, Adayalampattu, Tiruvallur,Chennai-600095.",EE,ELECTRICAL AND ELECTRONICSENGINEERING,24,23,-1
1125,"PMR Engineering College, Adayalampattu, Tiruvallur,Chennai-600095.",ME,MECHANICAL ENGINEERING,22,23,1
1125,"PMR Engineering College, Adayalampattu, Tiruvallur,Chennai-600095.",SC,Computer Science andEngineering (Cyber Security),23,23,0
1126,"JNN Institute of Engineering (Autonomous), UshaaGarden, 90, Kannigaipair Village, Uthukottai Taluk,Thiruvallur-601102.",AD,Artificial Intelligence and DataScience,27,55,28
1126,"JNN Institute of Engineering (Autonomous), UshaaGarden, 90, Kannigaipair Village, Uthukottai Taluk,Thiruvallur-601102.",AG,AGRICULTURE ENGINEERING,20,14,-6
1126,"JNN Institute of Engineering (Autonomous), UshaaGarden, 90, Kannigaipair Village, Uthukottai Taluk,Thiruvallur-601102.",BM,BIO MEDICAL ENGINEERING,19,18,-1
1126,"JNN Institute of Engineering (Autonomous), UshaaGarden, 90, Kannigaipair Village, Uthukottai Taluk,Thiruvallur-601102.",CS,COMPUTER SCIENCE ANDENGINEERING,40,81,41
1126,"JNN Institute of Engineering (Autonomous), UshaaGarden, 90, Kannigaipair Village, Uthukottai Taluk,Thiruvallur-601102.",EC,ELECTRONICS ANDCOMMUNICATIONENGINEERING,38,27,-11
1126,"JNN Institute of Engineering (Autonomous), UshaaGarden, 90, Kannigaipair Village, Uthukottai Taluk,Thiruvallur-601102.",EV,Electronics Engineering (VLSIDesign and Technology),37,41,4
1126,"JNN Institute of Engineering (Autonomous), UshaaGarden, 90, Kannigaipair Village, Uthukottai Taluk,Thiruvallur-601102.",RM,ROBOTICS AND AUTOMATION,19,14,-5
1126,"JNN Institute of Engineering (Autonomous), UshaaGarden, 90, Kannigaipair Village, Uthukottai Taluk,Thiruvallur-601102.",SC,Computer Science andEngineering (Cyber Security),27,36,9
1127,"St. Peter's College of Engineering and Technology,College Road, Avadi Taluk, Thiruvallur District,Chennai-600054.",AD,Artificial Intelligence and DataScience,44,35,-9
1127,"St. Peter's College of Engineering and Technology,College Road, Avadi Taluk, Thiruvallur District,Chennai-600054.",BT,BIO TECHNOLOGY,44,48,4
1127,"St. Peter's College of Engineering and Technology,College Road, Avadi Taluk, Thiruvallur District,Chennai-600054.",CE,CIVIL  ENGINEERING,24,28,4
1127,"St. Peter's College of Engineering and Technology,College Road, Avadi Taluk, Thiruvallur District,Chennai-600054.",CH,CHEMICAL  ENGINEERING,22,27,5
1127,"St. Peter's College of Engineering and Technology,College Road, Avadi Taluk, Thiruvallur District,Chennai-600054.",CS,COMPUTER SCIENCE ANDENGINEERING,45,71,26
1127,"St. Peter's College of Engineering and Technology,College Road, Avadi Taluk, Thiruvallur District,Chennai-600054.",EC,ELECTRONICS ANDCOMMUNICATIONENGINEERING,45,46,1
1127,"St. Peter's College of Engineering and Technology,College Road, Avadi Taluk, Thiruvallur District,Chennai-600054.",EE,ELECTRICAL AND ELECTRONICSENGINEERING,24,27,3
1127,"St. Peter's College of Engineering and Technology,College Road, Avadi Taluk, Thiruvallur District,Chennai-600054.",IT,INFORMATION TECHNOLOGY,43,90,47
1127,"St. Peter's College of Engineering and Technology,College Road, Avadi Taluk, Thiruvallur District,Chennai-600054.",ME,MECHANICAL ENGINEERING,22,27,5
1128,"R.M.K. College of Engineering and Technology(Autonomous), R.S.M. Nagar, Puduvoyal,Gummidipoondi Taluk, Thiruvallur District-601206.",AD,Artificial Intelligence and DataScience,53,54,1
1128,"R.M.K. College of Engineering and Technology(Autonomous), R.S.M. Nagar, Puduvoyal,Gummidipoondi Taluk, Thiruvallur District-601206.",CS,COMPUTER SCIENCE ANDENGINEERING,108,109,1
1128,"R.M.K. College of Engineering and Technology(Autonomous), R.S.M. Nagar, Puduvoyal,Gummidipoondi Taluk, Thiruvallur District-601206.",EC,ELECTRONICS ANDCOMMUNICATIONENGINEERING,55,55,0
1128,"R.M.K. College of Engineering and Technology(Autonomous), R.S.M. Nagar, Puduvoyal,Gummidipoondi Taluk, Thiruvallur District-601206.",EV,Electronics Engineering (VLSIDesign and Technology),0,27,27
1128,"R.M.K. College of Engineering and Technology(Autonomous), R.S.M. Nagar, Puduvoyal,Gummidipoondi Taluk, Thiruvallur District-601206.",SC,Computer Science andEngineering (Cyber Security),26,27,1
1133,"Annai Veilankannis College of Engineering, 33 GandhiRoad, Nedungundram, Chennai-600048.",AD,Artificial Intelligence and DataScience,35,43,8
1133,"Annai Veilankannis College of Engineering, 33 GandhiRoad, Nedungundram, Chennai-600048.",CE,CIVIL  ENGINEERING,23,23,0
1133,"Annai Veilankannis College of Engineering, 33 GandhiRoad, Nedungundram, Chennai-600048.",CS,COMPUTER SCIENCE ANDENGINEERING,35,44,9
1133,"Annai Veilankannis College of Engineering, 33 GandhiRoad, Nedungundram, Chennai-600048.",EC,ELECTRONICS ANDCOMMUNICATIONENGINEERING,35,44,9
1133,"Annai Veilankannis College of Engineering, 33 GandhiRoad, Nedungundram, Chennai-600048.",ME,MECHANICAL ENGINEERING,24,23,-1
1137,"Annai Mira College of Engineering and Technology,Arappakkam Village, Arcot Road, Walaja Taluk,Vellore District-632517.",AD,Artificial Intelligence and DataScience,35,71,36
1137,"Annai Mira College of Engineering and Technology,Arappakkam Village, Arcot Road, Walaja Taluk,Vellore District-632517.",CE,CIVIL  ENGINEERING,28,26,-2
1137,"Annai Mira College of Engineering and Technology,Arappakkam Village, Arcot Road, Walaja Taluk,Vellore District-632517.",CS,COMPUTER SCIENCE ANDENGINEERING,56,70,14
1137,"Annai Mira College of Engineering and Technology,Arappakkam Village, Arcot Road, Walaja Taluk,Vellore District-632517.",EC,ELECTRONICS ANDCOMMUNICATIONENGINEERING,52,35,-17
1137,"Annai Mira College of Engineering and Technology,Arappakkam Village, Arcot Road, Walaja Taluk,Vellore District-632517.",EE,ELECTRICAL AND ELECTRONICSENGINEERING,27,23,-4
1137,"Annai Mira College of Engineering and Technology,Arappakkam Village, Arcot Road, Walaja Taluk,Vellore District-632517.",IT,INFORMATION TECHNOLOGY,34,36,2
1137,"Annai Mira College of Engineering and Technology,Arappakkam Village, Arcot Road, Walaja Taluk,Vellore District-632517.",ME,MECHANICAL ENGINEERING,27,55,28
1140,"Jeppiaar Institute of Technology (Autonomous),Jeppiaar Nagar, Kunnam Village,Sriperumbudur Taluk,Kanchipuram-631604.",AD,Artificial Intelligence and DataScience,27,55,28
1140,"Jeppiaar Institute of Technology (Autonomous),Jeppiaar Nagar, Kunnam Village,Sriperumbudur Taluk,Kanchipuram-631604.",CB,COMPUTER SCIENCE ANDBUSSINESS SYSTEM,14,18,4
1140,"Jeppiaar Institute of Technology (Autonomous),Jeppiaar Nagar, Kunnam Village,Sriperumbudur Taluk,Kanchipuram-631604.",CS,COMPUTER SCIENCE ANDENGINEERING,62,100,38
1140,"Jeppiaar Institute of Technology (Autonomous),Jeppiaar Nagar, Kunnam Village,Sriperumbudur Taluk,Kanchipuram-631604.",EC,ELECTRONICS ANDCOMMUNICATIONENGINEERING,26,27,1
1140,"Jeppiaar Institute of Technology (Autonomous),Jeppiaar Nagar, Kunnam Village,Sriperumbudur Taluk,Kanchipuram-631604.",IT,INFORMATION TECHNOLOGY,27,136,109
1140,"Jeppiaar Institute of Technology (Autonomous),Jeppiaar Nagar, Kunnam Village,Sriperumbudur Taluk,Kanchipuram-631604.",ME,MECHANICAL ENGINEERING,14,17,3
1149,"St. Joseph's Institute of Technology (Autonomous),Jeppiaar Nagar, Old Mamallapuram Road,Kanchipuram, Chennai-600119.",AD,Artificial Intelligence and DataScience,81,82,1
1149,"St. Joseph's Institute of Technology (Autonomous),Jeppiaar Nagar, Old Mamallapuram Road,Kanchipuram, Chennai-600119.",CS,COMPUTER SCIENCE ANDENGINEERING,106,109,3
1149,"St. Joseph's Institute of Technology (Autonomous),Jeppiaar Nagar, Old Mamallapuram Road,Kanchipuram, Chennai-600119.",EC,ELECTRONICS ANDCOMMUNICATIONENGINEERING,81,82,1
1149,"St. Joseph's Institute of Technology (Autonomous),Jeppiaar Nagar, Old Mamallapuram Road,Kanchipuram, Chennai-600119.",EE,ELECTRICAL AND ELECTRONICSENGINEERING,55,45,-10
1149,"St. Joseph's Institute of Technology (Autonomous),Jeppiaar Nagar, Old Mamallapuram Road,Kanchipuram, Chennai-600119.",IT,INFORMATION TECHNOLOGY,108,109,1
1149,"St. Joseph's Institute of Technology (Autonomous),Jeppiaar Nagar, Old Mamallapuram Road,Kanchipuram, Chennai-600119.",ME,MECHANICAL ENGINEERING,55,36,-19
1149,"St. Joseph's Institute of Technology (Autonomous),Jeppiaar Nagar, Old Mamallapuram Road,Kanchipuram, Chennai-600119.",SC,Computer Science andEngineering (Cyber Security),0,45,45
1150,"Sri Jayaram Institute of Engineering and Technology,51 N,Elavur, 58 N Natham Village,GumudipoondiTaluk, Thiruvallur District-601201.",AD,Artificial Intelligence and DataScience,54,55,1
1150,"Sri Jayaram Institute of Engineering and Technology,51 N,Elavur, 58 N Natham Village,GumudipoondiTaluk, Thiruvallur District-601201.",AG,AGRICULTURE ENGINEERING,54,55,1
1150,"Sri Jayaram Institute of Engineering and Technology,51 N,Elavur, 58 N Natham Village,GumudipoondiTaluk, Thiruvallur District-601201.",BM,BIO MEDICAL ENGINEERING,55,54,-1
1150,"Sri Jayaram Institute of Engineering and Technology,51 N,Elavur, 58 N Natham Village,GumudipoondiTaluk, Thiruvallur District-601201.",CS,COMPUTER SCIENCE ANDENGINEERING,54,54,0
1150,"Sri Jayaram Institute of Engineering and Technology,51 N,Elavur, 58 N Natham Village,GumudipoondiTaluk, Thiruvallur District-601201.",ME,MECHANICAL ENGINEERING,54,54,0
1202,"DMI College of Engineering (Autonomous),St.Joseph's Town,Mevalurkuppam B Village,Nazarethpet Post, Palanchur, Kanchipuram, Chennai-600123.",AD,Artificial Intelligence and DataScience,43,55,12
1202,"DMI College of Engineering (Autonomous),St.Joseph's Town,Mevalurkuppam B Village,Nazarethpet Post, Palanchur, Kanchipuram, Chennai-600123.",AM,COMPUTER SCIENCE ANDENGINEERING (AI ANDMACHINE LEARNING),43,41,-2
1202,"DMI College of Engineering (Autonomous),St.Joseph's Town,Mevalurkuppam B Village,Nazarethpet Post, Palanchur, Kanchipuram, Chennai-600123.",CE,CIVIL  ENGINEERING,0,18,18
1202,"DMI College of Engineering (Autonomous),St.Joseph's Town,Mevalurkuppam B Village,Nazarethpet Post, Palanchur, Kanchipuram, Chennai-600123.",CS,COMPUTER SCIENCE ANDENGINEERING,91,73,-18
1202,"DMI College of Engineering (Autonomous),St.Joseph's Town,Mevalurkuppam B Village,Nazarethpet Post, Palanchur, Kanchipuram, Chennai-600123.",EC,ELECTRONICS ANDCOMMUNICATIONENGINEERING,44,41,-3
1202,"DMI College of Engineering (Autonomous),St.Joseph's Town,Mevalurkuppam B Village,Nazarethpet Post, Palanchur, Kanchipuram, Chennai-600123.",EE,ELECTRICAL AND ELECTRONICSENGINEERING,27,36,9
1202,"DMI College of Engineering (Autonomous),St.Joseph's Town,Mevalurkuppam B Village,Nazarethpet Post, Palanchur, Kanchipuram, Chennai-600123.",IT,INFORMATION TECHNOLOGY,42,36,-6
1202,"DMI College of Engineering (Autonomous),St.Joseph's Town,Mevalurkuppam B Village,Nazarethpet Post, Palanchur, Kanchipuram, Chennai-600123.",ME,MECHANICAL ENGINEERING,28,36,8
1207,"Kings Engineering College, Irungattukottai, Opp.Hyundai Car Company, Sriperumbudur, Kanchipuram-602117.",AD,Artificial Intelligence and DataScience,27,27,0
1207,"Kings Engineering College, Irungattukottai, Opp.Hyundai Car Company, Sriperumbudur, Kanchipuram-602117.",AM,COMPUTER SCIENCE ANDENGINEERING (AI ANDMACHINE LEARNING),14,27,13
1207,"Kings Engineering College, Irungattukottai, Opp.Hyundai Car Company, Sriperumbudur, Kanchipuram-602117.",BM,BIO MEDICAL ENGINEERING,55,45,-10
1207,"Kings Engineering College, Irungattukottai, Opp.Hyundai Car Company, Sriperumbudur, Kanchipuram-602117.",CS,COMPUTER SCIENCE ANDENGINEERING,52,91,39
1207,"Kings Engineering College, Irungattukottai, Opp.Hyundai Car Company, Sriperumbudur, Kanchipuram-602117.",EC,ELECTRONICS ANDCOMMUNICATIONENGINEERING,41,64,23
1207,"Kings Engineering College, Irungattukottai, Opp.Hyundai Car Company, Sriperumbudur, Kanchipuram-602117.",IT,INFORMATION TECHNOLOGY,54,90,36
1207,"Kings Engineering College, Irungattukottai, Opp.Hyundai Car Company, Sriperumbudur, Kanchipuram-602117.",ME,MECHANICAL ENGINEERING,27,22,-5
1207,"Kings Engineering College, Irungattukottai, Opp.Hyundai Car Company, Sriperumbudur, Kanchipuram-602117.",RM,ROBOTICS AND AUTOMATION,27,28,1
1209,"Pallavan College of Engineering, Thimmasamudram,Kanchipuram -631502.",CE,CIVIL  ENGINEERING,35,36,1
1209,"Pallavan College of Engineering, Thimmasamudram,Kanchipuram -631502.",CS,COMPUTER SCIENCE ANDENGINEERING,70,70,0
1209,"Pallavan College of Engineering, Thimmasamudram,Kanchipuram -631502.",EC,ELECTRONICS ANDCOMMUNICATIONENGINEERING,71,70,-1
1209,"Pallavan College of Engineering, Thimmasamudram,Kanchipuram -631502.",EE,ELECTRICAL AND ELECTRONICSENGINEERING,35,36,1
1209,"Pallavan College of Engineering, Thimmasamudram,Kanchipuram -631502.",IT,INFORMATION TECHNOLOGY,18,19,1
1209,"Pallavan College of Engineering, Thimmasamudram,Kanchipuram -631502.",ME,MECHANICAL ENGINEERING,71,70,-1
1210,"Panimalar Engineering College (Autonomous),Bangalore Trunk Road, NazarathPet,Varadharajapuram, Poonamallee, Thiruvallur (DT),Chennai-600123.",AD,Artificial Intelligence and DataScience,216,217,1
1210,"Panimalar Engineering College (Autonomous),Bangalore Trunk Road, NazarathPet,Varadharajapuram, Poonamallee, Thiruvallur (DT),Chennai-600123.",AL,Artificial Intelligence andMachine Learning,109,109,0
1210,"Panimalar Engineering College (Autonomous),Bangalore Trunk Road, NazarathPet,Varadharajapuram, Poonamallee, Thiruvallur (DT),Chennai-600123.",CB,COMPUTER SCIENCE ANDBUSSINESS SYSTEM,108,109,1
1210,"Panimalar Engineering College (Autonomous),Bangalore Trunk Road, NazarathPet,Varadharajapuram, Poonamallee, Thiruvallur (DT),Chennai-600123.",CS,COMPUTER SCIENCE ANDENGINEERING,326,435,109
1210,"Panimalar Engineering College (Autonomous),Bangalore Trunk Road, NazarathPet,Varadharajapuram, Poonamallee, Thiruvallur (DT),Chennai-600123.",EC,ELECTRONICS ANDCOMMUNICATIONENGINEERING,218,217,-1
1210,"Panimalar Engineering College (Autonomous),Bangalore Trunk Road, NazarathPet,Varadharajapuram, Poonamallee, Thiruvallur (DT),Chennai-600123.",EE,ELECTRICAL AND ELECTRONICSENGINEERING,81,82,1
1210,"Panimalar Engineering College (Autonomous),Bangalore Trunk Road, NazarathPet,Varadharajapuram, Poonamallee, Thiruvallur (DT),Chennai-600123.",IT,INFORMATION TECHNOLOGY,191,245,54
1210,"Panimalar Engineering College (Autonomous),Bangalore Trunk Road, NazarathPet,Varadharajapuram, Poonamallee, Thiruvallur (DT),Chennai-600123.",ME,MECHANICAL ENGINEERING,81,41,-40
1211,"Rajalakshmi Engineering College  (Autonomous),Rajalakshmi Nagar, Thandalam, Kanchipuram,Chennai-602105.",AD,Artificial Intelligence and DataScience,80,136,56
1211,"Rajalakshmi Engineering College  (Autonomous),Rajalakshmi Nagar, Thandalam, Kanchipuram,Chennai-602105.",AE,AERONAUTICAL ENGINEERING,27,27,0
1211,"Rajalakshmi Engineering College  (Autonomous),Rajalakshmi Nagar, Thandalam, Kanchipuram,Chennai-602105.",AL,Artificial Intelligence andMachine Learning,80,109,29
1211,"Rajalakshmi Engineering College  (Autonomous),Rajalakshmi Nagar, Thandalam, Kanchipuram,Chennai-602105.",AU,AUTOMOBILE ENGINEERING,14,14,0
1211,"Rajalakshmi Engineering College  (Autonomous),Rajalakshmi Nagar, Thandalam, Kanchipuram,Chennai-602105.",BM,BIO MEDICAL ENGINEERING,54,59,5
1211,"Rajalakshmi Engineering College  (Autonomous),Rajalakshmi Nagar, Thandalam, Kanchipuram,Chennai-602105.",BT,BIO TECHNOLOGY,81,81,0
1211,"Rajalakshmi Engineering College  (Autonomous),Rajalakshmi Nagar, Thandalam, Kanchipuram,Chennai-602105.",CB,COMPUTER SCIENCE ANDBUSSINESS SYSTEM,54,55,1
1211,"Rajalakshmi Engineering College  (Autonomous),Rajalakshmi Nagar, Thandalam, Kanchipuram,Chennai-602105.",CD,COMPUTER SCIENCE ANDDESIGN,26,27,1
1211,"Rajalakshmi Engineering College  (Autonomous),Rajalakshmi Nagar, Thandalam, Kanchipuram,Chennai-602105.",CE,CIVIL  ENGINEERING,27,27,0
1211,"Rajalakshmi Engineering College  (Autonomous),Rajalakshmi Nagar, Thandalam, Kanchipuram,Chennai-602105.",CH,CHEMICAL  ENGINEERING,27,30,3
1211,"Rajalakshmi Engineering College  (Autonomous),Rajalakshmi Nagar, Thandalam, Kanchipuram,Chennai-602105.",CS,COMPUTER SCIENCE ANDENGINEERING,135,245,110
1211,"Rajalakshmi Engineering College  (Autonomous),Rajalakshmi Nagar, Thandalam, Kanchipuram,Chennai-602105.",EC,ELECTRONICS ANDCOMMUNICATIONENGINEERING,109,162,53
1211,"Rajalakshmi Engineering College  (Autonomous),Rajalakshmi Nagar, Thandalam, Kanchipuram,Chennai-602105.",EE,ELECTRICAL AND ELECTRONICSENGINEERING,55,54,-1
1211,"Rajalakshmi Engineering College  (Autonomous),Rajalakshmi Nagar, Thandalam, Kanchipuram,Chennai-602105.",FD,FOOD TECHNOLOGY,27,27,0
1211,"Rajalakshmi Engineering College  (Autonomous),Rajalakshmi Nagar, Thandalam, Kanchipuram,Chennai-602105.",IT,INFORMATION TECHNOLOGY,109,136,27
1211,"Rajalakshmi Engineering College  (Autonomous),Rajalakshmi Nagar, Thandalam, Kanchipuram,Chennai-602105.",ME,MECHANICAL ENGINEERING,55,55,0
1211,"Rajalakshmi Engineering College  (Autonomous),Rajalakshmi Nagar, Thandalam, Kanchipuram,Chennai-602105.",MZ,Mechatronics Engineering,28,28,0
1211,"Rajalakshmi Engineering College  (Autonomous),Rajalakshmi Nagar, Thandalam, Kanchipuram,Chennai-602105.",RM,ROBOTICS AND AUTOMATION,28,27,-1
1211,"Rajalakshmi Engineering College  (Autonomous),Rajalakshmi Nagar, Thandalam, Kanchipuram,Chennai-602105.",SC,Computer Science andEngineering (Cyber Security),26,54,28
1212,"Rajiv Gandhi College of Engineering, Nemili Village,Sriperumbudur, Kanchipuram-602105.",AU,AUTOMOBILE ENGINEERING,27,27,0
1212,"Rajiv Gandhi College of Engineering, Nemili Village,Sriperumbudur, Kanchipuram-602105.",BM,BIO MEDICAL ENGINEERING,49,55,6
1212,"Rajiv Gandhi College of Engineering, Nemili Village,Sriperumbudur, Kanchipuram-602105.",CS,COMPUTER SCIENCE ANDENGINEERING,14,18,4
1212,"Rajiv Gandhi College of Engineering, Nemili Village,Sriperumbudur, Kanchipuram-602105.",EC,ELECTRONICS ANDCOMMUNICATIONENGINEERING,21,27,6
1212,"Rajiv Gandhi College of Engineering, Nemili Village,Sriperumbudur, Kanchipuram-602105.",EE,ELECTRICAL AND ELECTRONICSENGINEERING,27,28,1
1212,"Rajiv Gandhi College of Engineering, Nemili Village,Sriperumbudur, Kanchipuram-602105.",ME,MECHANICAL ENGINEERING,50,54,4
1212,"Rajiv Gandhi College of Engineering, Nemili Village,Sriperumbudur, Kanchipuram-602105.",PE,PETROLEUM ENGINEERING,23,27,4
1213,"S K R Engineering College, Agarmel, Poonamallaee,Thiruvallur, Chennai-600123.",BM,BIO MEDICAL ENGINEERING,37,27,-10
1213,"S K R Engineering College, Agarmel, Poonamallaee,Thiruvallur, Chennai-600123.",CB,COMPUTER SCIENCE ANDBUSSINESS SYSTEM,36,27,-9
1213,"S K R Engineering College, Agarmel, Poonamallaee,Thiruvallur, Chennai-600123.",CS,COMPUTER SCIENCE ANDENGINEERING,35,27,-8
1213,"S K R Engineering College, Agarmel, Poonamallaee,Thiruvallur, Chennai-600123.",EC,ELECTRONICS ANDCOMMUNICATIONENGINEERING,36,28,-8
1213,"S K R Engineering College, Agarmel, Poonamallaee,Thiruvallur, Chennai-600123.",EE,ELECTRICAL AND ELECTRONICSENGINEERING,19,14,-5
1213,"S K R Engineering College, Agarmel, Poonamallaee,Thiruvallur, Chennai-600123.",IT,INFORMATION TECHNOLOGY,36,27,-9
1216,"Saveetha Engineering College (Autonomous),Saveetha Nagar, Thandalam Post, SriperumbudurTaluk, Kancheepuram District-602105.",AD,Artificial Intelligence and DataScience,140,177,37
1216,"Saveetha Engineering College (Autonomous),Saveetha Nagar, Thandalam Post, SriperumbudurTaluk, Kancheepuram District-602105.",AG,AGRICULTURE ENGINEERING,18,17,-1
1216,"Saveetha Engineering College (Autonomous),Saveetha Nagar, Thandalam Post, SriperumbudurTaluk, Kancheepuram District-602105.",AL,Artificial Intelligence andMachine Learning,107,106,-1
1216,"Saveetha Engineering College (Autonomous),Saveetha Nagar, Thandalam Post, SriperumbudurTaluk, Kancheepuram District-602105.",BM,BIO MEDICAL ENGINEERING,18,36,18
1216,"Saveetha Engineering College (Autonomous),Saveetha Nagar, Thandalam Post, SriperumbudurTaluk, Kancheepuram District-602105.",CE,CIVIL  ENGINEERING,18,17,-1
1216,"Saveetha Engineering College (Autonomous),Saveetha Nagar, Thandalam Post, SriperumbudurTaluk, Kancheepuram District-602105.",CH,CHEMICAL  ENGINEERING,18,17,-1
1216,"Saveetha Engineering College (Autonomous),Saveetha Nagar, Thandalam Post, SriperumbudurTaluk, Kancheepuram District-602105.",CI,Computer Science andEngineering (Internet of Things),35,35,0
1216,"Saveetha Engineering College (Autonomous),Saveetha Nagar, Thandalam Post, SriperumbudurTaluk, Kancheepuram District-602105.",CS,COMPUTER SCIENCE ANDENGINEERING,141,213,72
1216,"Saveetha Engineering College (Autonomous),Saveetha Nagar, Thandalam Post, SriperumbudurTaluk, Kancheepuram District-602105.",EC,ELECTRONICS ANDCOMMUNICATIONENGINEERING,176,177,1
1216,"Saveetha Engineering College (Autonomous),Saveetha Nagar, Thandalam Post, SriperumbudurTaluk, Kancheepuram District-602105.",EE,ELECTRICAL AND ELECTRONICSENGINEERING,35,36,1
1216,Saveetha Engineering College (Autonomous)Thandalam  Sriperumpudur Taluk  KancheepuramDistrict 602105,EI,ELECTRONICS ANDINSTRUMENTATIONENGINEERING,17,0,-17
1216,"Saveetha Engineering College (Autonomous),Saveetha Nagar, Thandalam Post, SriperumbudurTaluk, Kancheepuram District-602105.",IT,INFORMATION TECHNOLOGY,70,72,2
1216,Saveetha Engineering College (Autonomous)Thandalam  Sriperumpudur Taluk  KancheepuramDistrict 602105,MD,MEDICAL ELECTRONICSENGINEERING,18,0,-18
1216,"Saveetha Engineering College (Autonomous),Saveetha Nagar, Thandalam Post, SriperumbudurTaluk, Kancheepuram District-602105.",ME,MECHANICAL ENGINEERING,35,35,0
1216,"Saveetha Engineering College (Autonomous),Saveetha Nagar, Thandalam Post, SriperumbudurTaluk, Kancheepuram District-602105.",SC,Computer Science andEngineering (Cyber Security),35,35,0
1217,"Sree Sastha Institute of Engineering and Technology,Chennai-Bangalore Highway, Chembarambakkam,Thiruvallur District, Chennai-600123.",AD,Artificial Intelligence and DataScience,35,39,4
1217,"Sree Sastha Institute of Engineering and Technology,Chennai-Bangalore Highway, Chembarambakkam,Thiruvallur District, Chennai-600123.",AM,COMPUTER SCIENCE ANDENGINEERING (AI ANDMACHINE LEARNING),18,19,1
1217,"Sree Sastha Institute of Engineering and Technology,Chennai-Bangalore Highway, Chembarambakkam,Thiruvallur District, Chennai-600123.",AU,AUTOMOBILE ENGINEERING,18,19,1
1217,"Sree Sastha Institute of Engineering and Technology,Chennai-Bangalore Highway, Chembarambakkam,Thiruvallur District, Chennai-600123.",BM,BIO MEDICAL ENGINEERING,18,20,2
1217,"Sree Sastha Institute of Engineering and Technology,Chennai-Bangalore Highway, Chembarambakkam,Thiruvallur District, Chennai-600123.",BT,BIO TECHNOLOGY,35,39,4
1217,"Sree Sastha Institute of Engineering and Technology,Chennai-Bangalore Highway, Chembarambakkam,Thiruvallur District, Chennai-600123.",CB,COMPUTER SCIENCE ANDBUSSINESS SYSTEM,35,35,0
1217,"Sree Sastha Institute of Engineering and Technology,Chennai-Bangalore Highway, Chembarambakkam,Thiruvallur District, Chennai-600123.",CE,CIVIL  ENGINEERING,18,21,3
1217,"Sree Sastha Institute of Engineering and Technology,Chennai-Bangalore Highway, Chembarambakkam,Thiruvallur District, Chennai-600123.",CS,COMPUTER SCIENCE ANDENGINEERING,34,41,7
1217,"Sree Sastha Institute of Engineering and Technology,Chennai-Bangalore Highway, Chembarambakkam,Thiruvallur District, Chennai-600123.",EC,ELECTRONICS ANDCOMMUNICATIONENGINEERING,70,82,12
1217,"Sree Sastha Institute of Engineering and Technology,Chennai-Bangalore Highway, Chembarambakkam,Thiruvallur District, Chennai-600123.",EE,ELECTRICAL AND ELECTRONICSENGINEERING,18,21,3
1217,"Sree Sastha Institute of Engineering and Technology,Chennai-Bangalore Highway, Chembarambakkam,Thiruvallur District, Chennai-600123.",FD,FOOD TECHNOLOGY,35,39,4
1217,"Sree Sastha Institute of Engineering and Technology,Chennai-Bangalore Highway, Chembarambakkam,Thiruvallur District, Chennai-600123.",IT,INFORMATION TECHNOLOGY,35,35,0
1217,"Sree Sastha Institute of Engineering and Technology,Chennai-Bangalore Highway, Chembarambakkam,Thiruvallur District, Chennai-600123.",MU,MECHANICAL ANDAUTOMATION ENGINEERING,18,21,3
1217,"Sree Sastha Institute of Engineering and Technology,Chennai-Bangalore Highway, Chembarambakkam,Thiruvallur District, Chennai-600123.",SC,Computer Science andEngineering (Cyber Security),18,20,2
1218,"Sri Muthukumaran Institute of Technology,Chikkarayapuram Near Mangadu, Kanchipuram,Chennai-600069.",AD,Artificial Intelligence and DataScience,27,36,9
1218,"Sri Muthukumaran Institute of Technology,Chikkarayapuram Near Mangadu, Kanchipuram,Chennai-600069.",BM,BIO MEDICAL ENGINEERING,36,41,5
1218,"Sri Muthukumaran Institute of Technology,Chikkarayapuram Near Mangadu, Kanchipuram,Chennai-600069.",CE,CIVIL  ENGINEERING,14,23,9
1218,"Sri Muthukumaran Institute of Technology,Chikkarayapuram Near Mangadu, Kanchipuram,Chennai-600069.",CS,COMPUTER SCIENCE ANDENGINEERING,68,68,0
1218,"Sri Muthukumaran Institute of Technology,Chikkarayapuram Near Mangadu, Kanchipuram,Chennai-600069.",EC,ELECTRONICS ANDCOMMUNICATIONENGINEERING,27,41,14
1218,"Sri Muthukumaran Institute of Technology,Chikkarayapuram Near Mangadu, Kanchipuram,Chennai-600069.",EE,ELECTRICAL AND ELECTRONICSENGINEERING,27,41,14
1218,"Sri Muthukumaran Institute of Technology,Chikkarayapuram Near Mangadu, Kanchipuram,Chennai-600069.",IT,INFORMATION TECHNOLOGY,36,36,0
1218,"Sri Muthukumaran Institute of Technology,Chikkarayapuram Near Mangadu, Kanchipuram,Chennai-600069.",ME,MECHANICAL ENGINEERING,27,41,14
1218,"Sri Muthukumaran Institute of Technology,Chikkarayapuram Near Mangadu, Kanchipuram,Chennai-600069.",MZ,Mechatronics Engineering,14,22,8
1218,"Sri Muthukumaran Institute of Technology,Chikkarayapuram Near Mangadu, Kanchipuram,Chennai-600069.",PH,PHARMACEUTICALTECHNOLOGY,18,23,5
1218,"Sri Muthukumaran Institute of Technology,Chikkarayapuram Near Mangadu, Kanchipuram,Chennai-600069.",RM,ROBOTICS AND AUTOMATION,27,41,14
1219,"Sri Venkateswara College of Engineering(Autonomous), Post Bag No.3, Pennalur,Sriperumbudur, Kanchipuram-602105.",AD,Artificial Intelligence and DataScience,53,64,11
1219,Sri Venkateswara College of Engineering (Autonomous)Post Bag No.1  Chennai-Bengaluru High Road  PennalurIrungattukottai S.O.  Sriperumbudur TalukKancheepuram District 602105,AU,AUTOMOBILE ENGINEERING,22,0,-22
1219,"Sri Venkateswara College of Engineering(Autonomous), Post Bag No.3, Pennalur,Sriperumbudur, Kanchipuram-602105.",BT,BIO TECHNOLOGY,27,27,0
1219,"Sri Venkateswara College of Engineering(Autonomous), Post Bag No.3, Pennalur,Sriperumbudur, Kanchipuram-602105.",CE,CIVIL  ENGINEERING,14,36,22
1219,"Sri Venkateswara College of Engineering(Autonomous), Post Bag No.3, Pennalur,Sriperumbudur, Kanchipuram-602105.",CH,CHEMICAL  ENGINEERING,28,27,-1
1219,"Sri Venkateswara College of Engineering(Autonomous), Post Bag No.3, Pennalur,Sriperumbudur, Kanchipuram-602105.",CS,COMPUTER SCIENCE ANDENGINEERING,80,109,29
1219,"Sri Venkateswara College of Engineering(Autonomous), Post Bag No.3, Pennalur,Sriperumbudur, Kanchipuram-602105.",EC,ELECTRONICS ANDCOMMUNICATIONENGINEERING,81,81,0
1219,"Sri Venkateswara College of Engineering(Autonomous), Post Bag No.3, Pennalur,Sriperumbudur, Kanchipuram-602105.",EE,ELECTRICAL AND ELECTRONICSENGINEERING,54,55,1
1219,"Sri Venkateswara College of Engineering(Autonomous), Post Bag No.3, Pennalur,Sriperumbudur, Kanchipuram-602105.",IT,INFORMATION TECHNOLOGY,55,68,13
1219,"Sri Venkateswara College of Engineering(Autonomous), Post Bag No.3, Pennalur,Sriperumbudur, Kanchipuram-602105.",MB,Mechanical Engineering(Automobile),0,18,18
1219,"Sri Venkateswara College of Engineering(Autonomous), Post Bag No.3, Pennalur,Sriperumbudur, Kanchipuram-602105.",ME,MECHANICAL ENGINEERING,27,27,0
1219,"Sri Venkateswara College of Engineering(Autonomous), Post Bag No.3, Pennalur,Sriperumbudur, Kanchipuram-602105.",MR,MARINE ENGINEERING,20,23,3
1219,"Sri Venkateswara College of Engineering(Autonomous), Post Bag No.3, Pennalur,Sriperumbudur, Kanchipuram-602105.",MU,MECHANICAL ANDAUTOMATION ENGINEERING,36,32,-4
1221,"Jaya College of Engineering and Technology,Poonamallee By Pass Road, Parivakkam, Chennai,Thiruvallur-600056.",CS,COMPUTER SCIENCE ANDENGINEERING,15,22,7
1221,"Jaya College of Engineering and Technology,Poonamallee By Pass Road, Parivakkam, Chennai,Thiruvallur-600056.",EC,ELECTRONICS ANDCOMMUNICATIONENGINEERING,25,23,-2
1221,"Jaya College of Engineering and Technology,Poonamallee By Pass Road, Parivakkam, Chennai,Thiruvallur-600056.",MD,MEDICAL ELECTRONICSENGINEERING,53,41,-12
1221,"Jaya College of Engineering and Technology,Poonamallee By Pass Road, Parivakkam, Chennai,Thiruvallur-600056.",ME,MECHANICAL ENGINEERING,52,41,-11
1222,"P.B. College of Engineering, Chennai-Bangalore HighWay, Irungkattukottai, Sriperumbudur Taluk,Kancheepuram District, Chennai -602117.",AD,Artificial Intelligence and DataScience,19,18,-1
1222,"P.B. College of Engineering, Chennai-Bangalore HighWay, Irungkattukottai, Sriperumbudur Taluk,Kancheepuram District, Chennai -602117.",AE,AERONAUTICAL ENGINEERING,23,23,0
1222,"P.B. College of Engineering, Chennai-Bangalore HighWay, Irungkattukottai, Sriperumbudur Taluk,Kancheepuram District, Chennai -602117.",AU,AUTOMOBILE ENGINEERING,24,27,3
1222,"P.B. College of Engineering, Chennai-Bangalore HighWay, Irungkattukottai, Sriperumbudur Taluk,Kancheepuram District, Chennai -602117.",CE,CIVIL  ENGINEERING,14,14,0
1222,"P.B. College of Engineering, Chennai-Bangalore HighWay, Irungkattukottai, Sriperumbudur Taluk,Kancheepuram District, Chennai -602117.",CS,COMPUTER SCIENCE ANDENGINEERING,72,64,-8
1222,"P.B. College of Engineering, Chennai-Bangalore HighWay, Irungkattukottai, Sriperumbudur Taluk,Kancheepuram District, Chennai -602117.",EC,ELECTRONICS ANDCOMMUNICATIONENGINEERING,52,45,-7
1222,"P.B. College of Engineering, Chennai-Bangalore HighWay, Irungkattukottai, Sriperumbudur Taluk,Kancheepuram District, Chennai -602117.",EE,ELECTRICAL AND ELECTRONICSENGINEERING,24,23,-1
1222,"P.B. College of Engineering, Chennai-Bangalore HighWay, Irungkattukottai, Sriperumbudur Taluk,Kancheepuram District, Chennai -602117.",IT,INFORMATION TECHNOLOGY,47,41,-6
1222,"P.B. College of Engineering, Chennai-Bangalore HighWay, Irungkattukottai, Sriperumbudur Taluk,Kancheepuram District, Chennai -602117.",ME,MECHANICAL ENGINEERING,27,23,-4
1222,"P.B. College of Engineering, Chennai-Bangalore HighWay, Irungkattukottai, Sriperumbudur Taluk,Kancheepuram District, Chennai -602117.",SC,Computer Science andEngineering (Cyber Security),24,24,0
1225,"Loyola Institute of Technology, Palanchur,Mevalurkuppam, B village, Nazarathpet Post,Sriperumpudur Taluk, Kanchipuram District, Chennai-600123.",AD,Artificial Intelligence and DataScience,34,36,2
1225,"Loyola Institute of Technology, Palanchur,Mevalurkuppam, B village, Nazarathpet Post,Sriperumpudur Taluk, Kanchipuram District, Chennai-600123.",CS,COMPUTER SCIENCE ANDENGINEERING,36,36,0
1225,"Loyola Institute of Technology, Palanchur,Mevalurkuppam, B village, Nazarathpet Post,Sriperumpudur Taluk, Kanchipuram District, Chennai-600123.",EC,ELECTRONICS ANDCOMMUNICATIONENGINEERING,36,36,0
1225,"Loyola Institute of Technology, Palanchur,Mevalurkuppam, B village, Nazarathpet Post,Sriperumpudur Taluk, Kanchipuram District, Chennai-600123.",EE,ELECTRICAL AND ELECTRONICSENGINEERING,23,19,-4
1225,"Loyola Institute of Technology, Palanchur,Mevalurkuppam, B village, Nazarathpet Post,Sriperumpudur Taluk, Kanchipuram District, Chennai-600123.",IT,INFORMATION TECHNOLOGY,36,36,0
1225,"Loyola Institute of Technology, Palanchur,Mevalurkuppam, B village, Nazarathpet Post,Sriperumpudur Taluk, Kanchipuram District, Chennai-600123.",ME,MECHANICAL ENGINEERING,18,14,-4
1225,"Loyola Institute of Technology, Palanchur,Mevalurkuppam, B village, Nazarathpet Post,Sriperumpudur Taluk, Kanchipuram District, Chennai-600123.",SC,Computer Science andEngineering (Cyber Security),26,36,10
1226,"P.T.Lee Chengalvaraya Naicker College of Engineeringand Technology, Oovery, Veliyur Post, KanchipuramDistrict-631502.",AD,Artificial Intelligence and DataScience,55,37,-18
1226,"P.T.Lee Chengalvaraya Naicker College of Engineeringand Technology, Oovery, Veliyur Post, KanchipuramDistrict-631502.",CS,COMPUTER SCIENCE ANDENGINEERING,45,89,44
1226,"P.T.Lee Chengalvaraya Naicker College of Engineeringand Technology, Oovery, Veliyur Post, KanchipuramDistrict-631502.",EC,ELECTRONICS ANDCOMMUNICATIONENGINEERING,53,45,-8
1226,"P.T.Lee Chengalvaraya Naicker College of Engineeringand Technology, Oovery, Veliyur Post, KanchipuramDistrict-631502.",EE,ELECTRICAL AND ELECTRONICSENGINEERING,54,55,1
1226,"P.T.Lee Chengalvaraya Naicker College of Engineeringand Technology, Oovery, Veliyur Post, KanchipuramDistrict-631502.",IT,INFORMATION TECHNOLOGY,45,35,-10
1226,"P.T.Lee Chengalvaraya Naicker College of Engineeringand Technology, Oovery, Veliyur Post, KanchipuramDistrict-631502.",ME,MECHANICAL ENGINEERING,54,53,-1
1228,"Alpha College of Engineering, No.34, Udayavar KovilStreet, Thirumazhisai, Chennai-600124.",AD,Artificial Intelligence and DataScience,35,36,1
1228,"Alpha College of Engineering, No.34, Udayavar KovilStreet, Thirumazhisai, Chennai-600124.",BM,BIO MEDICAL ENGINEERING,35,18,-17
1228,"Alpha College of Engineering, No.34, Udayavar KovilStreet, Thirumazhisai, Chennai-600124.",CS,COMPUTER SCIENCE ANDENGINEERING,35,36,1
1228,"Alpha College of Engineering, No.34, Udayavar KovilStreet, Thirumazhisai, Chennai-600124.",EC,ELECTRONICS ANDCOMMUNICATIONENGINEERING,18,19,1
1228,"Alpha College of Engineering, No.34, Udayavar KovilStreet, Thirumazhisai, Chennai-600124.",IT,INFORMATION TECHNOLOGY,34,35,1
1228,Alpha College of Engineering  No.34  Udayavar KoilStreet  Poonamallee  Thirumazhisai  Chennai - 600124,ME,MECHANICAL ENGINEERING,19,0,-19
1228,"Alpha College of Engineering, No.34, Udayavar KovilStreet, Thirumazhisai, Chennai-600124.",RM,ROBOTICS AND AUTOMATION,0,16,16
1228,"Alpha College of Engineering, No.34, Udayavar KovilStreet, Thirumazhisai, Chennai-600124.",SC,Computer Science andEngineering (Cyber Security),0,35,35
1229,"Indira Institute of Engineering and Technology, No.1,V.G.R Nagar, V.G.R Gardens, Pandur, Thiruvallur -631203.",AD,Artificial Intelligence and DataScience,46,41,-5
1229,"Indira Institute of Engineering and Technology, No.1,V.G.R Nagar, V.G.R Gardens, Pandur, Thiruvallur -631203.",CE,CIVIL  ENGINEERING,23,24,1
1229,"Indira Institute of Engineering and Technology, No.1,V.G.R Nagar, V.G.R Gardens, Pandur, Thiruvallur -631203.",CS,COMPUTER SCIENCE ANDENGINEERING,44,41,-3
1229,"Indira Institute of Engineering and Technology, No.1,V.G.R Nagar, V.G.R Gardens, Pandur, Thiruvallur -631203.",EC,ELECTRONICS ANDCOMMUNICATIONENGINEERING,46,45,-1
1229,"Indira Institute of Engineering and Technology, No.1,V.G.R Nagar, V.G.R Gardens, Pandur, Thiruvallur -631203.",EE,ELECTRICAL AND ELECTRONICSENGINEERING,45,45,0
1229,"Indira Institute of Engineering and Technology, No.1,V.G.R Nagar, V.G.R Gardens, Pandur, Thiruvallur -631203.",ME,MECHANICAL ENGINEERING,45,45,0
1230,"Apollo Engineering College, MevaloorkuppamValarpuram Post, Sriperumbudur Taluk, KanchipuramDistrict-602105.",AD,Artificial Intelligence and DataScience,35,36,1
1230,"Apollo Engineering College, MevaloorkuppamValarpuram Post, Sriperumbudur Taluk, KanchipuramDistrict-602105.",AE,AERONAUTICAL ENGINEERING,36,35,-1
1230,"Apollo Engineering College, MevaloorkuppamValarpuram Post, Sriperumbudur Taluk, KanchipuramDistrict-602105.",CB,COMPUTER SCIENCE ANDBUSSINESS SYSTEM,35,35,0
1230,"Apollo Engineering College, MevaloorkuppamValarpuram Post, Sriperumbudur Taluk, KanchipuramDistrict-602105.",CS,COMPUTER SCIENCE ANDENGINEERING,35,35,0
1230,"Apollo Engineering College, MevaloorkuppamValarpuram Post, Sriperumbudur Taluk, KanchipuramDistrict-602105.",EC,ELECTRONICS ANDCOMMUNICATIONENGINEERING,35,36,1
1230,"Apollo Engineering College, MevaloorkuppamValarpuram Post, Sriperumbudur Taluk, KanchipuramDistrict-602105.",EE,ELECTRICAL AND ELECTRONICSENGINEERING,18,18,0
1230,"Apollo Engineering College, MevaloorkuppamValarpuram Post, Sriperumbudur Taluk, KanchipuramDistrict-602105.",ME,MECHANICAL ENGINEERING,35,35,0
1230,"Apollo Engineering College, MevaloorkuppamValarpuram Post, Sriperumbudur Taluk, KanchipuramDistrict-602105.",SC,Computer Science andEngineering (Cyber Security),18,18,0
1232,"ARM College of Engineering and Technology,Sattamangalam,Maraimalainagar Post, ChengalpattuTaluk, Kanchipuram Dist-603209.",AD,Artificial Intelligence and DataScience,34,36,2
1232,"ARM College of Engineering and Technology,Sattamangalam,Maraimalainagar Post, ChengalpattuTaluk, Kanchipuram Dist-603209.",CE,CIVIL  ENGINEERING,18,18,0
1232,"ARM College of Engineering and Technology,Sattamangalam,Maraimalainagar Post, ChengalpattuTaluk, Kanchipuram Dist-603209.",CS,COMPUTER SCIENCE ANDENGINEERING,35,37,2
1232,"ARM College of Engineering and Technology,Sattamangalam,Maraimalainagar Post, ChengalpattuTaluk, Kanchipuram Dist-603209.",EC,ELECTRONICS ANDCOMMUNICATIONENGINEERING,35,36,1
1232,"ARM College of Engineering and Technology,Sattamangalam,Maraimalainagar Post, ChengalpattuTaluk, Kanchipuram Dist-603209.",EE,ELECTRICAL AND ELECTRONICSENGINEERING,18,16,-2
1232,"ARM College of Engineering and Technology,Sattamangalam,Maraimalainagar Post, ChengalpattuTaluk, Kanchipuram Dist-603209.",IT,INFORMATION TECHNOLOGY,36,35,-1
1232,"ARM College of Engineering and Technology,Sattamangalam,Maraimalainagar Post, ChengalpattuTaluk, Kanchipuram Dist-603209.",ME,MECHANICAL ENGINEERING,36,35,-1
1232,"ARM College of Engineering and Technology,Sattamangalam,Maraimalainagar Post, ChengalpattuTaluk, Kanchipuram Dist-603209.",SC,Computer Science andEngineering (Cyber Security),35,35,0
1233,"Adhi College of Engineering and Technology, No. 6,Munu  Adhi Nagar, Sankarapuram, PuliambakkamPost, Near Wallajabad Kancheepuram-631605.",AD,Artificial Intelligence and DataScience,40,35,-5
1233,"Adhi College of Engineering and Technology, No. 6,Munu  Adhi Nagar, Sankarapuram, PuliambakkamPost, Near Wallajabad Kancheepuram-631605.",CS,COMPUTER SCIENCE ANDENGINEERING,45,108,63
1233,"Adhi College of Engineering and Technology, No. 6,Munu  Adhi Nagar, Sankarapuram, PuliambakkamPost, Near Wallajabad Kancheepuram-631605.",EC,ELECTRONICS ANDCOMMUNICATIONENGINEERING,55,55,0
1233,"Adhi College of Engineering and Technology, No. 6,Munu  Adhi Nagar, Sankarapuram, PuliambakkamPost, Near Wallajabad Kancheepuram-631605.",EE,ELECTRICAL AND ELECTRONICSENGINEERING,54,54,0
1233,"Adhi College of Engineering and Technology, No. 6,Munu  Adhi Nagar, Sankarapuram, PuliambakkamPost, Near Wallajabad Kancheepuram-631605.",IT,INFORMATION TECHNOLOGY,40,41,1
1233,"Adhi College of Engineering and Technology, No. 6,Munu  Adhi Nagar, Sankarapuram, PuliambakkamPost, Near Wallajabad Kancheepuram-631605.",ME,MECHANICAL ENGINEERING,54,55,1
1235,"Jei Mathaajee College of Engineering, No.124,Vishakandikuppam Village, Siruvakkam Post,Kanchipuram-631552.",CE,CIVIL  ENGINEERING,49,50,1
1235,"Jei Mathaajee College of Engineering, No.124,Vishakandikuppam Village, Siruvakkam Post,Kanchipuram-631552.",CS,COMPUTER SCIENCE ANDENGINEERING,51,50,-1
1235,"Jei Mathaajee College of Engineering, No.124,Vishakandikuppam Village, Siruvakkam Post,Kanchipuram-631552.",EC,ELECTRONICS ANDCOMMUNICATIONENGINEERING,26,26,0
1235,"Jei Mathaajee College of Engineering, No.124,Vishakandikuppam Village, Siruvakkam Post,Kanchipuram-631552.",EE,ELECTRICAL AND ELECTRONICSENGINEERING,50,51,1
1235,"Jei Mathaajee College of Engineering, No.124,Vishakandikuppam Village, Siruvakkam Post,Kanchipuram-631552.",IT,INFORMATION TECHNOLOGY,14,14,0
1235,"Jei Mathaajee College of Engineering, No.124,Vishakandikuppam Village, Siruvakkam Post,Kanchipuram-631552.",ME,MECHANICAL ENGINEERING,26,22,-4
1237,"Velammal Institute of Technology, Chennai - KolkattaHighway, Pancheeti Village, Ponneri Taluk, ThiruvallurDistrict-601204.",AD,Artificial Intelligence and DataScience,70,70,0
1237,"Velammal Institute of Technology, Chennai - KolkattaHighway, Pancheeti Village, Ponneri Taluk, ThiruvallurDistrict-601204.",CS,COMPUTER SCIENCE ANDENGINEERING,141,142,1
1237,"Velammal Institute of Technology, Chennai - KolkattaHighway, Pancheeti Village, Ponneri Taluk, ThiruvallurDistrict-601204.",EC,ELECTRONICS ANDCOMMUNICATIONENGINEERING,70,70,0
1237,"Velammal Institute of Technology, Chennai - KolkattaHighway, Pancheeti Village, Ponneri Taluk, ThiruvallurDistrict-601204.",EE,ELECTRICAL AND ELECTRONICSENGINEERING,18,18,0
1237,"Velammal Institute of Technology, Chennai - KolkattaHighway, Pancheeti Village, Ponneri Taluk, ThiruvallurDistrict-601204.",IT,INFORMATION TECHNOLOGY,54,52,-2
1237,"Velammal Institute of Technology, Chennai - KolkattaHighway, Pancheeti Village, Ponneri Taluk, ThiruvallurDistrict-601204.",ME,MECHANICAL ENGINEERING,23,23,0
1237,"Velammal Institute of Technology, Chennai - KolkattaHighway, Pancheeti Village, Ponneri Taluk, ThiruvallurDistrict-601204.",MZ,Mechatronics Engineering,22,23,1
1238,"GRT Institute of Engineering and Technology, GRTMahalakshmi Nagar, Chennai-Tirupathi Highway,Tiruttani, Thiruvallur-631209.",AD,Artificial Intelligence and DataScience,34,70,36
1238,"GRT Institute of Engineering and Technology, GRTMahalakshmi Nagar, Chennai-Tirupathi Highway,Tiruttani, Thiruvallur-631209.",BM,BIO MEDICAL ENGINEERING,35,17,-18
1238,"GRT Institute of Engineering and Technology, GRTMahalakshmi Nagar, Chennai-Tirupathi Highway,Tiruttani, Thiruvallur-631209.",CS,COMPUTER SCIENCE ANDENGINEERING,71,71,0
1238,"GRT Institute of Engineering and Technology, GRTMahalakshmi Nagar, Chennai-Tirupathi Highway,Tiruttani, Thiruvallur-631209.",EC,ELECTRONICS ANDCOMMUNICATIONENGINEERING,35,35,0
1238,"GRT Institute of Engineering and Technology, GRTMahalakshmi Nagar, Chennai-Tirupathi Highway,Tiruttani, Thiruvallur-631209.",EE,ELECTRICAL AND ELECTRONICSENGINEERING,18,18,0
1238,"GRT Institute of Engineering and Technology, GRTMahalakshmi Nagar, Chennai-Tirupathi Highway,Tiruttani, Thiruvallur-631209.",IT,INFORMATION TECHNOLOGY,0,35,35
1238,"GRT Institute of Engineering and Technology, GRTMahalakshmi Nagar, Chennai-Tirupathi Highway,Tiruttani, Thiruvallur-631209.",ME,MECHANICAL ENGINEERING,18,19,1
1241,"T.J.S. Engineering College, Peruvoyal, NearKavaraipettai,Gummidipoondi Taluk,ThiruvallurDistrict-601206.",AD,Artificial Intelligence and DataScience,36,35,-1
1241,"T.J.S. Engineering College, Peruvoyal, NearKavaraipettai,Gummidipoondi Taluk,ThiruvallurDistrict-601206.",AM,COMPUTER SCIENCE ANDENGINEERING (AI ANDMACHINE LEARNING),0,16,16
1241,"T.J.S. Engineering College, Peruvoyal, NearKavaraipettai,Gummidipoondi Taluk,ThiruvallurDistrict-601206.",CS,COMPUTER SCIENCE ANDENGINEERING,53,52,-1
1241,"T.J.S. Engineering College, Peruvoyal, NearKavaraipettai,Gummidipoondi Taluk,ThiruvallurDistrict-601206.",EC,ELECTRONICS ANDCOMMUNICATIONENGINEERING,44,36,-8
1241,"T.J.S. Engineering College, Peruvoyal, NearKavaraipettai,Gummidipoondi Taluk,ThiruvallurDistrict-601206.",EE,ELECTRICAL AND ELECTRONICSENGINEERING,22,19,-3
1241,"T.J.S. Engineering College, Peruvoyal, NearKavaraipettai,Gummidipoondi Taluk,ThiruvallurDistrict-601206.",IT,INFORMATION TECHNOLOGY,0,36,36
1241,"T.J.S. Engineering College, Peruvoyal, NearKavaraipettai,Gummidipoondi Taluk,ThiruvallurDistrict-601206.",ME,MECHANICAL ENGINEERING,35,18,-17
1243,"Madha Institute of Engineering and Technology,Irandaam Kattalai, Sadhananthapuram, Thandalampost, Chennai-600122.",AD,Artificial Intelligence and DataScience,28,23,-5
1243,"Madha Institute of Engineering and Technology,Irandaam Kattalai, Sadhananthapuram, Thandalampost, Chennai-600122.",CE,CIVIL  ENGINEERING,27,27,0
1243,"Madha Institute of Engineering and Technology,Irandaam Kattalai, Sadhananthapuram, Thandalampost, Chennai-600122.",CS,COMPUTER SCIENCE ANDENGINEERING,28,23,-5
1243,"Madha Institute of Engineering and Technology,Irandaam Kattalai, Sadhananthapuram, Thandalampost, Chennai-600122.",EC,ELECTRONICS ANDCOMMUNICATIONENGINEERING,28,27,-1
1243,"Madha Institute of Engineering and Technology,Irandaam Kattalai, Sadhananthapuram, Thandalampost, Chennai-600122.",EE,ELECTRICAL AND ELECTRONICSENGINEERING,26,27,1
1243,"Madha Institute of Engineering and Technology,Irandaam Kattalai, Sadhananthapuram, Thandalampost, Chennai-600122.",IT,INFORMATION TECHNOLOGY,26,27,1
1243,"Madha Institute of Engineering and Technology,Irandaam Kattalai, Sadhananthapuram, Thandalampost, Chennai-600122.",ME,MECHANICAL ENGINEERING,26,27,1
1243,"Madha Institute of Engineering and Technology,Irandaam Kattalai, Sadhananthapuram, Thandalampost, Chennai-600122.",SC,Computer Science andEngineering (Cyber Security),27,27,0
1301,"Mohamed Sathak A J College of Engineering(Autonomous), #34, Rajiv Gandhi Road(OMR), ITHighway, Siruseri, Egattur, Chennai-603103.",AD,Artificial Intelligence and DataScience,14,31,17
1301,"Mohamed Sathak A J College of Engineering(Autonomous), #34, Rajiv Gandhi Road(OMR), ITHighway, Siruseri, Egattur, Chennai-603103.",AM,COMPUTER SCIENCE ANDENGINEERING (AI ANDMACHINE LEARNING),0,36,36
1301,"Mohamed Sathak A J College of Engineering(Autonomous), #34, Rajiv Gandhi Road(OMR), ITHighway, Siruseri, Egattur, Chennai-603103.",CB,COMPUTER SCIENCE ANDBUSSINESS SYSTEM,13,18,5
1301,"Mohamed Sathak A J College of Engineering(Autonomous), #34, Rajiv Gandhi Road(OMR), ITHighway, Siruseri, Egattur, Chennai-603103.",CE,CIVIL  ENGINEERING,14,14,0
1301,"Mohamed Sathak A J College of Engineering(Autonomous), #34, Rajiv Gandhi Road(OMR), ITHighway, Siruseri, Egattur, Chennai-603103.",CS,COMPUTER SCIENCE ANDENGINEERING,26,27,1
1301,"Mohamed Sathak A J College of Engineering(Autonomous), #34, Rajiv Gandhi Road(OMR), ITHighway, Siruseri, Egattur, Chennai-603103.",EA,Electronics and Communication(Advanced CommunicationTechnology),0,18,18
1301,"Mohamed Sathak A J College of Engineering(Autonomous), #34, Rajiv Gandhi Road(OMR), ITHighway, Siruseri, Egattur, Chennai-603103.",EC,ELECTRONICS ANDCOMMUNICATIONENGINEERING,27,41,14
1301,"Mohamed Sathak A J College of Engineering(Autonomous), #34, Rajiv Gandhi Road(OMR), ITHighway, Siruseri, Egattur, Chennai-603103.",EE,ELECTRICAL AND ELECTRONICSENGINEERING,14,14,0
1301,"Mohamed Sathak A J College of Engineering(Autonomous), #34, Rajiv Gandhi Road(OMR), ITHighway, Siruseri, Egattur, Chennai-603103.",EV,Electronics Engineering (VLSIDesign and Technology),0,18,18
1301,"Mohamed Sathak A J College of Engineering(Autonomous), #34, Rajiv Gandhi Road(OMR), ITHighway, Siruseri, Egattur, Chennai-603103.",IT,INFORMATION TECHNOLOGY,27,36,9
1301,"Mohamed Sathak A J College of Engineering(Autonomous), #34, Rajiv Gandhi Road(OMR), ITHighway, Siruseri, Egattur, Chennai-603103.",ME,MECHANICAL ENGINEERING,13,14,1
1301,"Mohamed Sathak A J College of Engineering(Autonomous), #34, Rajiv Gandhi Road(OMR), ITHighway, Siruseri, Egattur, Chennai-603103.",SC,Computer Science andEngineering (Cyber Security),14,14,0
1303,"Anand Institute of Higher Technology, KalasalingamNagar, Old Mahabalipuram Road, Kazhipattur Village,Chengalpattu Taluk, Kancheepuram District-603103.",AD,Artificial Intelligence and DataScience,80,92,12
1303,"Anand Institute of Higher Technology, KalasalingamNagar, Old Mahabalipuram Road, Kazhipattur Village,Chengalpattu Taluk, Kancheepuram District-603103.",AG,AGRICULTURE ENGINEERING,34,36,2
1303,"Anand Institute of Higher Technology, KalasalingamNagar, Old Mahabalipuram Road, Kazhipattur Village,Chengalpattu Taluk, Kancheepuram District-603103.",BT,BIO TECHNOLOGY,43,51,8
1303,"Anand Institute of Higher Technology, KalasalingamNagar, Old Mahabalipuram Road, Kazhipattur Village,Chengalpattu Taluk, Kancheepuram District-603103.",CB,COMPUTER SCIENCE ANDBUSSINESS SYSTEM,41,49,8
1303,"Anand Institute of Higher Technology, KalasalingamNagar, Old Mahabalipuram Road, Kazhipattur Village,Chengalpattu Taluk, Kancheepuram District-603103.",CS,COMPUTER SCIENCE ANDENGINEERING,77,98,21
1303,"Anand Institute of Higher Technology, KalasalingamNagar, Old Mahabalipuram Road, Kazhipattur Village,Chengalpattu Taluk, Kancheepuram District-603103.",EC,ELECTRONICS ANDCOMMUNICATIONENGINEERING,44,50,6
1303,"Anand Institute of Higher Technology, KalasalingamNagar, Old Mahabalipuram Road, Kazhipattur Village,Chengalpattu Taluk, Kancheepuram District-603103.",EE,ELECTRICAL AND ELECTRONICSENGINEERING,22,18,-4
1303,"Anand Institute of Higher Technology, KalasalingamNagar, Old Mahabalipuram Road, Kazhipattur Village,Chengalpattu Taluk, Kancheepuram District-603103.",IT,INFORMATION TECHNOLOGY,38,46,8
1303,"Anand Institute of Higher Technology, KalasalingamNagar, Old Mahabalipuram Road, Kazhipattur Village,Chengalpattu Taluk, Kancheepuram District-603103.",ME,MECHANICAL ENGINEERING,35,35,0
1304,"Easwari Engineering College (Autonomous), BharathiSalai, Ramapuram, Chennai-600089.",AD,Artificial Intelligence and DataScience,28,109,81
1304,"Easwari Engineering College (Autonomous), BharathiSalai, Ramapuram, Chennai-600089.",AM,COMPUTER SCIENCE ANDENGINEERING (AI ANDMACHINE LEARNING),27,55,28
1304,"Easwari Engineering College (Autonomous), BharathiSalai, Ramapuram, Chennai-600089.",AU,AUTOMOBILE ENGINEERING,28,14,-14
1304,"Easwari Engineering College (Autonomous), BharathiSalai, Ramapuram, Chennai-600089.",BM,BIO MEDICAL ENGINEERING,27,27,0
1304,"Easwari Engineering College (Autonomous), BharathiSalai, Ramapuram, Chennai-600089.",BT,BIO TECHNOLOGY,0,27,27
1304,"Easwari Engineering College (Autonomous), BharathiSalai, Ramapuram, Chennai-600089.",CB,COMPUTER SCIENCE ANDBUSSINESS SYSTEM,0,27,27
1304,"Easwari Engineering College (Autonomous), BharathiSalai, Ramapuram, Chennai-600089.",CD,COMPUTER SCIENCE ANDDESIGN,0,27,27
1304,"Easwari Engineering College (Autonomous), BharathiSalai, Ramapuram, Chennai-600089.",CE,CIVIL  ENGINEERING,27,27,0
1304,"Easwari Engineering College (Autonomous), BharathiSalai, Ramapuram, Chennai-600089.",CS,COMPUTER SCIENCE ANDENGINEERING,80,190,110
1304,"Easwari Engineering College (Autonomous), BharathiSalai, Ramapuram, Chennai-600089.",EC,ELECTRONICS ANDCOMMUNICATIONENGINEERING,80,109,29
1304,"Easwari Engineering College (Autonomous), BharathiSalai, Ramapuram, Chennai-600089.",EE,ELECTRICAL AND ELECTRONICSENGINEERING,28,54,26
1304,"Easwari Engineering College (Autonomous), BharathiSalai, Ramapuram, Chennai-600089.",IT,INFORMATION TECHNOLOGY,80,136,56
1304,"Easwari Engineering College (Autonomous), BharathiSalai, Ramapuram, Chennai-600089.",ME,MECHANICAL ENGINEERING,54,54,0
1304,"Easwari Engineering College (Autonomous), BharathiSalai, Ramapuram, Chennai-600089.",RM,ROBOTICS AND AUTOMATION,27,27,0
1304,"Easwari Engineering College (Autonomous), BharathiSalai, Ramapuram, Chennai-600089.",SC,Computer Science andEngineering (Cyber Security),26,28,2
1306,"Jeppiaar Engineering College, Jeppiaar Nagar, OldMammallapuram Road, Kanchipuram, Chennai-600119.",AD,Artificial Intelligence and DataScience,27,55,28
1306,"Jeppiaar Engineering College, Jeppiaar Nagar, OldMammallapuram Road, Kanchipuram, Chennai-600119.",AM,COMPUTER SCIENCE ANDENGINEERING (AI ANDMACHINE LEARNING),0,27,27
1306,"Jeppiaar Engineering College, Jeppiaar Nagar, OldMammallapuram Road, Kanchipuram, Chennai-600119.",AO,AEROSPACE ENGINEERING,0,21,21
1306,"Jeppiaar Engineering College, Jeppiaar Nagar, OldMammallapuram Road, Kanchipuram, Chennai-600119.",BT,BIO TECHNOLOGY,14,18,4
1306,"Jeppiaar Engineering College, Jeppiaar Nagar, OldMammallapuram Road, Kanchipuram, Chennai-600119.",CS,COMPUTER SCIENCE ANDENGINEERING,65,82,17
1306,"Jeppiaar Engineering College, Jeppiaar Nagar, OldMammallapuram Road, Kanchipuram, Chennai-600119.",EC,ELECTRONICS ANDCOMMUNICATIONENGINEERING,64,72,8
1306,"Jeppiaar Engineering College, Jeppiaar Nagar, OldMammallapuram Road, Kanchipuram, Chennai-600119.",EE,ELECTRICAL AND ELECTRONICSENGINEERING,0,21,21
1306,"Jeppiaar Engineering College, Jeppiaar Nagar, OldMammallapuram Road, Kanchipuram, Chennai-600119.",IT,INFORMATION TECHNOLOGY,54,55,1
1306,"Jeppiaar Engineering College, Jeppiaar Nagar, OldMammallapuram Road, Kanchipuram, Chennai-600119.",ME,MECHANICAL ENGINEERING,41,36,-5
1307,"Jerusalem College of Engineering (Autonomous),Velachery-Tambaram Main Road,Narayanapuram,Pallikkaranai,Chennai-600100.",AD,Artificial Intelligence and DataScience,35,37,2
1307,"Jerusalem College of Engineering (Autonomous),Velachery-Tambaram Main Road,Narayanapuram,Pallikkaranai,Chennai-600100.",AM,COMPUTER SCIENCE ANDENGINEERING (AI ANDMACHINE LEARNING),34,35,1
1307,"Jerusalem College of Engineering (Autonomous),Velachery-Tambaram Main Road,Narayanapuram,Pallikkaranai,Chennai-600100.",BM,BIO MEDICAL ENGINEERING,31,35,4
1307,"Jerusalem College of Engineering (Autonomous),Velachery-Tambaram Main Road,Narayanapuram,Pallikkaranai,Chennai-600100.",CB,COMPUTER SCIENCE ANDBUSSINESS SYSTEM,18,17,-1
1307,"Jerusalem College of Engineering (Autonomous),Velachery-Tambaram Main Road,Narayanapuram,Pallikkaranai,Chennai-600100.",CS,COMPUTER SCIENCE ANDENGINEERING,64,71,7
1307,"Jerusalem College of Engineering (Autonomous),Velachery-Tambaram Main Road,Narayanapuram,Pallikkaranai,Chennai-600100.",EC,ELECTRONICS ANDCOMMUNICATIONENGINEERING,35,35,0
1307,"Jerusalem College of Engineering (Autonomous),Velachery-Tambaram Main Road,Narayanapuram,Pallikkaranai,Chennai-600100.",EE,ELECTRICAL AND ELECTRONICSENGINEERING,18,18,0
1307,"Jerusalem College of Engineering (Autonomous),Velachery-Tambaram Main Road,Narayanapuram,Pallikkaranai,Chennai-600100.",IT,INFORMATION TECHNOLOGY,31,54,23
1307,"Jerusalem College of Engineering (Autonomous),Velachery-Tambaram Main Road,Narayanapuram,Pallikkaranai,Chennai-600100.",SC,Computer Science andEngineering (Cyber Security),35,35,0
1309,"Meenakshi Sundararajan Engineering College(Autonomous), C/O I.I.E.T Society No.363, ArcotRoad, Kodambakkam, Chennai-600024.",AD,Artificial Intelligence and DataScience,35,71,36
1309,"Meenakshi Sundararajan Engineering College(Autonomous), C/O I.I.E.T Society No.363, ArcotRoad, Kodambakkam, Chennai-600024.",CE,CIVIL  ENGINEERING,41,53,12
1309,"Meenakshi Sundararajan Engineering College(Autonomous), C/O I.I.E.T Society No.363, ArcotRoad, Kodambakkam, Chennai-600024.",CS,COMPUTER SCIENCE ANDENGINEERING,34,71,37
1309,"Meenakshi Sundararajan Engineering College(Autonomous), C/O I.I.E.T Society No.363, ArcotRoad, Kodambakkam, Chennai-600024.",EC,ELECTRONICS ANDCOMMUNICATIONENGINEERING,70,71,1
1309,"Meenakshi Sundararajan Engineering College(Autonomous), C/O I.I.E.T Society No.363, ArcotRoad, Kodambakkam, Chennai-600024.",EE,ELECTRICAL AND ELECTRONICSENGINEERING,35,49,14
1309,"Meenakshi Sundararajan Engineering College(Autonomous), C/O I.I.E.T Society No.363, ArcotRoad, Kodambakkam, Chennai-600024.",IT,INFORMATION TECHNOLOGY,36,71,35
1309,"Meenakshi Sundararajan Engineering College(Autonomous), C/O I.I.E.T Society No.363, ArcotRoad, Kodambakkam, Chennai-600024.",ME,MECHANICAL ENGINEERING,41,49,8
1310,"Misrimal Navajee Munoth Jain Engineering College,Guru Marudhar Kesari Building, Jyothi Nagar,Thorapakkam, Chennai-600097.",AD,Artificial Intelligence and DataScience,25,27,2
1310,"Misrimal Navajee Munoth Jain Engineering College,Guru Marudhar Kesari Building, Jyothi Nagar,Thorapakkam, Chennai-600097.",CB,COMPUTER SCIENCE ANDBUSSINESS SYSTEM,14,14,0
1310,"Misrimal Navajee Munoth Jain Engineering College,Guru Marudhar Kesari Building, Jyothi Nagar,Thorapakkam, Chennai-600097.",CE,CIVIL  ENGINEERING,14,14,0
1310,"Misrimal Navajee Munoth Jain Engineering College,Guru Marudhar Kesari Building, Jyothi Nagar,Thorapakkam, Chennai-600097.",CS,COMPUTER SCIENCE ANDENGINEERING,27,26,-1
1310,"Misrimal Navajee Munoth Jain Engineering College,Guru Marudhar Kesari Building, Jyothi Nagar,Thorapakkam, Chennai-600097.",EC,ELECTRONICS ANDCOMMUNICATIONENGINEERING,26,27,1
1310,"Misrimal Navajee Munoth Jain Engineering College,Guru Marudhar Kesari Building, Jyothi Nagar,Thorapakkam, Chennai-600097.",EE,ELECTRICAL AND ELECTRONICSENGINEERING,14,14,0
1310,"Misrimal Navajee Munoth Jain Engineering College,Guru Marudhar Kesari Building, Jyothi Nagar,Thorapakkam, Chennai-600097.",IT,INFORMATION TECHNOLOGY,27,27,0
1310,"Misrimal Navajee Munoth Jain Engineering College,Guru Marudhar Kesari Building, Jyothi Nagar,Thorapakkam, Chennai-600097.",ME,MECHANICAL ENGINEERING,14,14,0
1311,"KCG college of Technology (Autonomous), RajivGandhi Salai, Karapakkam, Chennai-600097.",AD,Artificial Intelligence and DataScience,26,26,0
1311,"KCG college of Technology (Autonomous), RajivGandhi Salai, Karapakkam, Chennai-600097.",AE,AERONAUTICAL ENGINEERING,27,27,0
1311,"KCG college of Technology (Autonomous), RajivGandhi Salai, Karapakkam, Chennai-600097.",AO,AEROSPACE ENGINEERING,27,27,0
1311,"KCG college of Technology (Autonomous), RajivGandhi Salai, Karapakkam, Chennai-600097.",AU,AUTOMOBILE ENGINEERING,14,14,0
1311,"KCG college of Technology (Autonomous), RajivGandhi Salai, Karapakkam, Chennai-600097.",CE,CIVIL  ENGINEERING,14,14,0
1311,"KCG college of Technology (Autonomous), RajivGandhi Salai, Karapakkam, Chennai-600097.",CS,COMPUTER SCIENCE ANDENGINEERING,80,81,1
1311,"KCG college of Technology (Autonomous), RajivGandhi Salai, Karapakkam, Chennai-600097.",EC,ELECTRONICS ANDCOMMUNICATIONENGINEERING,40,54,14
1311,"KCG college of Technology (Autonomous), RajivGandhi Salai, Karapakkam, Chennai-600097.",EE,ELECTRICAL AND ELECTRONICSENGINEERING,14,27,13
1311,"KCG college of Technology (Autonomous), RajivGandhi Salai, Karapakkam, Chennai-600097.",FT,FASHION TECHNOLOGY,14,14,0
1311,"KCG college of Technology (Autonomous), RajivGandhi Salai, Karapakkam, Chennai-600097.",IT,INFORMATION TECHNOLOGY,55,55,0
1311,"KCG college of Technology (Autonomous), RajivGandhi Salai, Karapakkam, Chennai-600097.",ME,MECHANICAL ENGINEERING,14,14,0
1311,"KCG college of Technology (Autonomous), RajivGandhi Salai, Karapakkam, Chennai-600097.",MZ,Mechatronics Engineering,13,14,1
1311,"KCG college of Technology (Autonomous), RajivGandhi Salai, Karapakkam, Chennai-600097.",SC,Computer Science andEngineering (Cyber Security),27,27,0
1313,Shree Motilal Kanhaiyalal (SMK)Fomra Institute ofTechnology  Old Mahabalipuram Road (OMR)Kelambakkam  Chengalpattu District 603103,AD,ARTIFICIAL INTELLIGENCEAND DATA SCIENCE,40,0,-40
1313,Shree Motilal Kanhaiyalal (SMK)Fomra Institute ofTechnology  Old Mahabalipuram Road (OMR)Kelambakkam  Chengalpattu District 603103,BM,BIO MEDICAL ENGINEERING,27,0,-27
1313,Shree Motilal Kanhaiyalal (SMK)Fomra Institute ofTechnology  Old Mahabalipuram Road (OMR)Kelambakkam  Chengalpattu District 603103,CS,COMPUTER SCIENCE ANDENGINEERING,41,0,-41
1313,Shree Motilal Kanhaiyalal (SMK)Fomra Institute ofTechnology  Old Mahabalipuram Road (OMR)Kelambakkam  Chengalpattu District 603103,EC,ELECTRONICS ANDCOMMUNICATIONENGINEERING,22,0,-22
1313,Shree Motilal Kanhaiyalal (SMK)Fomra Institute ofTechnology  Old Mahabalipuram Road (OMR)Kelambakkam  Chengalpattu District 603103,EE,ELECTRICAL ANDELECTRONICS ENGINEERING,14,0,-14
1313,Shree Motilal Kanhaiyalal (SMK)Fomra Institute ofTechnology  Old Mahabalipuram Road (OMR)Kelambakkam  Chengalpattu District 603103,IT,INFORMATION TECHNOLOGY,18,0,-18
1313,Shree Motilal Kanhaiyalal (SMK)Fomra Institute ofTechnology  Old Mahabalipuram Road (OMR)Kelambakkam  Chengalpattu District 603103,ME,MECHANICAL ENGINEERING,14,0,-14
1315,"Sri Sivasubramaniya Nadar College of Engineering(Autonomous), Rajiv Gandhi Salai (OMR),Kalavakkam,Kanchipuram District-603110.",BM,BIO MEDICAL ENGINEERING,35,36,1
1315,"Sri Sivasubramaniya Nadar College of Engineering(Autonomous), Rajiv Gandhi Salai (OMR),Kalavakkam,Kanchipuram District-603110.",CE,CIVIL  ENGINEERING,34,36,2
1315,"Sri Sivasubramaniya Nadar College of Engineering(Autonomous), Rajiv Gandhi Salai (OMR),Kalavakkam,Kanchipuram District-603110.",CH,CHEMICAL  ENGINEERING,35,36,1
1315,"Sri Sivasubramaniya Nadar College of Engineering(Autonomous), Rajiv Gandhi Salai (OMR),Kalavakkam,Kanchipuram District-603110.",CJ,M.Tech. Computer Science andEngineering (Integrated 5years),34,35,1
1315,"Sri Sivasubramaniya Nadar College of Engineering(Autonomous), Rajiv Gandhi Salai (OMR),Kalavakkam,Kanchipuram District-603110.",CS,COMPUTER SCIENCE ANDENGINEERING,86,106,20
1315,"Sri Sivasubramaniya Nadar College of Engineering(Autonomous), Rajiv Gandhi Salai (OMR),Kalavakkam,Kanchipuram District-603110.",EC,ELECTRONICS ANDCOMMUNICATIONENGINEERING,70,71,1
1315,"Sri Sivasubramaniya Nadar College of Engineering(Autonomous), Rajiv Gandhi Salai (OMR),Kalavakkam,Kanchipuram District-603110.",EE,ELECTRICAL AND ELECTRONICSENGINEERING,70,70,0
1315,"Sri Sivasubramaniya Nadar College of Engineering(Autonomous), Rajiv Gandhi Salai (OMR),Kalavakkam,Kanchipuram District-603110.",IT,INFORMATION TECHNOLOGY,89,70,-19
1315,"Sri Sivasubramaniya Nadar College of Engineering(Autonomous), Rajiv Gandhi Salai (OMR),Kalavakkam,Kanchipuram District-603110.",ME,MECHANICAL ENGINEERING,70,70,0
1316,"Agni College of Technology (Autonomous),Thalambur Off.Rajiv Gandhi Salai, Chengalpattu Taluk,Kancheepuram District-603103.",AD,Artificial Intelligence and DataScience,33,36,3
1316,"Agni College of Technology (Autonomous),Thalambur Off.Rajiv Gandhi Salai, Chengalpattu Taluk,Kancheepuram District-603103.",BM,BIO MEDICAL ENGINEERING,41,47,6
1316,"Agni College of Technology (Autonomous),Thalambur Off.Rajiv Gandhi Salai, Chengalpattu Taluk,Kancheepuram District-603103.",CE,CIVIL  ENGINEERING,22,27,5
1316,"Agni College of Technology (Autonomous),Thalambur Off.Rajiv Gandhi Salai, Chengalpattu Taluk,Kancheepuram District-603103.",CH,CHEMICAL  ENGINEERING,18,27,9
1316,"Agni College of Technology (Autonomous),Thalambur Off.Rajiv Gandhi Salai, Chengalpattu Taluk,Kancheepuram District-603103.",CS,COMPUTER SCIENCE ANDENGINEERING,106,106,0
1316,"Agni College of Technology (Autonomous),Thalambur Off.Rajiv Gandhi Salai, Chengalpattu Taluk,Kancheepuram District-603103.",EC,ELECTRONICS ANDCOMMUNICATIONENGINEERING,35,35,0
1316,"Agni College of Technology (Autonomous),Thalambur Off.Rajiv Gandhi Salai, Chengalpattu Taluk,Kancheepuram District-603103.",EE,ELECTRICAL AND ELECTRONICSENGINEERING,18,18,0
1316,"Agni College of Technology (Autonomous),Thalambur Off.Rajiv Gandhi Salai, Chengalpattu Taluk,Kancheepuram District-603103.",IT,INFORMATION TECHNOLOGY,70,70,0
1316,"Agni College of Technology (Autonomous),Thalambur Off.Rajiv Gandhi Salai, Chengalpattu Taluk,Kancheepuram District-603103.",ME,MECHANICAL ENGINEERING,21,25,4
1316,"Agni College of Technology (Autonomous),Thalambur Off.Rajiv Gandhi Salai, Chengalpattu Taluk,Kancheepuram District-603103.",MZ,Mechatronics Engineering,41,35,-6
1317,"St. Joseph's College of Engineering (Autonomous),Jeppiaar Nagar, Old Mamallapuram Road,Kanchipuram, Chennai-600119.",AD,Artificial Intelligence and DataScience,81,109,28
1317,"St. Joseph's College of Engineering (Autonomous),Jeppiaar Nagar, Old Mamallapuram Road,Kanchipuram, Chennai-600119.",AL,Artificial Intelligence andMachine Learning,55,55,0
1317,"St. Joseph's College of Engineering (Autonomous),Jeppiaar Nagar, Old Mamallapuram Road,Kanchipuram, Chennai-600119.",BT,BIO TECHNOLOGY,27,27,0
1317,"St. Joseph's College of Engineering (Autonomous),Jeppiaar Nagar, Old Mamallapuram Road,Kanchipuram, Chennai-600119.",CH,CHEMICAL  ENGINEERING,45,45,0
1317,"St. Joseph's College of Engineering (Autonomous),Jeppiaar Nagar, Old Mamallapuram Road,Kanchipuram, Chennai-600119.",CS,COMPUTER SCIENCE ANDENGINEERING,108,136,28
1317,"St. Joseph's College of Engineering (Autonomous),Jeppiaar Nagar, Old Mamallapuram Road,Kanchipuram, Chennai-600119.",EC,ELECTRONICS ANDCOMMUNICATIONENGINEERING,80,81,1
1317,"St. Joseph's College of Engineering (Autonomous),Jeppiaar Nagar, Old Mamallapuram Road,Kanchipuram, Chennai-600119.",EE,ELECTRICAL AND ELECTRONICSENGINEERING,127,55,-72
1317,"St. Joseph's College of Engineering (Autonomous),Jeppiaar Nagar, Old Mamallapuram Road,Kanchipuram, Chennai-600119.",IT,INFORMATION TECHNOLOGY,109,109,0
1317,"St. Joseph's College of Engineering (Autonomous),Jeppiaar Nagar, Old Mamallapuram Road,Kanchipuram, Chennai-600119.",ME,MECHANICAL ENGINEERING,150,64,-86
1317,"St. Joseph's College of Engineering (Autonomous),Jeppiaar Nagar, Old Mamallapuram Road,Kanchipuram, Chennai-600119.",MZ,Mechatronics Engineering,0,22,22
1317,"St. Joseph's College of Engineering (Autonomous),Jeppiaar Nagar, Old Mamallapuram Road,Kanchipuram, Chennai-600119.",SC,Computer Science andEngineering (Cyber Security),0,27,27
1318,"T.J. Institute of Technology, Rajiv Gandhi Salai,Karapakkam, Chennai-600097.",AD,Artificial Intelligence and DataScience,27,28,1
1318,"T.J. Institute of Technology, Rajiv Gandhi Salai,Karapakkam, Chennai-600097.",AM,COMPUTER SCIENCE ANDENGINEERING (AI ANDMACHINE LEARNING),27,28,1
1318,"T.J. Institute of Technology, Rajiv Gandhi Salai,Karapakkam, Chennai-600097.",CE,CIVIL  ENGINEERING,27,27,0
1318,"T.J. Institute of Technology, Rajiv Gandhi Salai,Karapakkam, Chennai-600097.",CS,COMPUTER SCIENCE ANDENGINEERING,53,55,2
1318,"T.J. Institute of Technology, Rajiv Gandhi Salai,Karapakkam, Chennai-600097.",EC,ELECTRONICS ANDCOMMUNICATIONENGINEERING,27,27,0
1318,"T.J. Institute of Technology, Rajiv Gandhi Salai,Karapakkam, Chennai-600097.",EE,ELECTRICAL AND ELECTRONICSENGINEERING,27,26,-1
1318,"T.J. Institute of Technology, Rajiv Gandhi Salai,Karapakkam, Chennai-600097.",IT,INFORMATION TECHNOLOGY,28,27,-1
1318,"T.J. Institute of Technology, Rajiv Gandhi Salai,Karapakkam, Chennai-600097.",ME,MECHANICAL ENGINEERING,28,27,-1
1318,"T.J. Institute of Technology, Rajiv Gandhi Salai,Karapakkam, Chennai-600097.",SC,Computer Science andEngineering (Cyber Security),27,27,0
1319,"Thangavelu Engineering College, Rajiv Gandhi Salai,Karapakkam, Chennai-600097.",AD,Artificial Intelligence and DataScience,35,36,1
1319,"Thangavelu Engineering College, Rajiv Gandhi Salai,Karapakkam, Chennai-600097.",CE,CIVIL  ENGINEERING,35,35,0
1319,"Thangavelu Engineering College, Rajiv Gandhi Salai,Karapakkam, Chennai-600097.",CS,COMPUTER SCIENCE ANDENGINEERING,70,70,0
1319,"Thangavelu Engineering College, Rajiv Gandhi Salai,Karapakkam, Chennai-600097.",EC,ELECTRONICS ANDCOMMUNICATIONENGINEERING,35,35,0
1319,"Thangavelu Engineering College, Rajiv Gandhi Salai,Karapakkam, Chennai-600097.",EE,ELECTRICAL AND ELECTRONICSENGINEERING,19,19,0
1319,"Thangavelu Engineering College, Rajiv Gandhi Salai,Karapakkam, Chennai-600097.",EI,ELECTRONICS ANDINSTRUMENTATIONENGINEERING,18,18,0
1319,"Thangavelu Engineering College, Rajiv Gandhi Salai,Karapakkam, Chennai-600097.",IT,INFORMATION TECHNOLOGY,35,35,0
1319,"Thangavelu Engineering College, Rajiv Gandhi Salai,Karapakkam, Chennai-600097.",ME,MECHANICAL ENGINEERING,35,35,0
1321,Central Institute of Petrochemicals Engineering andTechnology (Formerly Central Institute of PlasticsEngineering and Technology) (CIPET)  GuindyChennai 600032,MN,MANUFACTURINGENGINEERING,55,55,0
1321,Central Institute of Petrochemicals Engineering andTechnology (Formerly Central Institute of PlasticsEngineering and Technology) (CIPET)  GuindyChennai 600032,PA,PLASTIC TECHNOLOGY,54,55,1
1322,"Dhanalakshmi Srinivasan College of Engineering andTechnology, ECR, Poonjeri, Mamallapuram,Kanchipuram-603104.",AD,Artificial Intelligence and DataScience,81,163,82
1322,"Dhanalakshmi Srinivasan College of Engineering andTechnology, ECR, Poonjeri, Mamallapuram,Kanchipuram-603104.",AE,AERONAUTICAL ENGINEERING,41,45,4
1322,"Dhanalakshmi Srinivasan College of Engineering andTechnology, ECR, Poonjeri, Mamallapuram,Kanchipuram-603104.",AG,AGRICULTURE ENGINEERING,40,45,5
1322,"Dhanalakshmi Srinivasan College of Engineering andTechnology, ECR, Poonjeri, Mamallapuram,Kanchipuram-603104.",AM,COMPUTER SCIENCE ANDENGINEERING (AI ANDMACHINE LEARNING),0,45,45
1322,"Dhanalakshmi Srinivasan College of Engineering andTechnology, ECR, Poonjeri, Mamallapuram,Kanchipuram-603104.",BM,BIO MEDICAL ENGINEERING,41,45,4
1322,"Dhanalakshmi Srinivasan College of Engineering andTechnology, ECR, Poonjeri, Mamallapuram,Kanchipuram-603104.",CE,CIVIL  ENGINEERING,40,55,15
1322,"Dhanalakshmi Srinivasan College of Engineering andTechnology, ECR, Poonjeri, Mamallapuram,Kanchipuram-603104.",CS,COMPUTER SCIENCE ANDENGINEERING,123,200,77
1322,"Dhanalakshmi Srinivasan College of Engineering andTechnology, ECR, Poonjeri, Mamallapuram,Kanchipuram-603104.",EC,ELECTRONICS ANDCOMMUNICATIONENGINEERING,41,45,4
1322,"Dhanalakshmi Srinivasan College of Engineering andTechnology, ECR, Poonjeri, Mamallapuram,Kanchipuram-603104.",EE,ELECTRICAL AND ELECTRONICSENGINEERING,41,55,14
1322,"Dhanalakshmi Srinivasan College of Engineering andTechnology, ECR, Poonjeri, Mamallapuram,Kanchipuram-603104.",FD,FOOD TECHNOLOGY,41,45,4
1322,"Dhanalakshmi Srinivasan College of Engineering andTechnology, ECR, Poonjeri, Mamallapuram,Kanchipuram-603104.",IT,INFORMATION TECHNOLOGY,81,181,100
1322,"Dhanalakshmi Srinivasan College of Engineering andTechnology, ECR, Poonjeri, Mamallapuram,Kanchipuram-603104.",ME,MECHANICAL ENGINEERING,41,55,14
1322,"Dhanalakshmi Srinivasan College of Engineering andTechnology, ECR, Poonjeri, Mamallapuram,Kanchipuram-603104.",SC,Computer Science andEngineering (Cyber Security),41,41,0
1324,"Sri Sai Ram Institute of Technology (Autonomous), SaiLeo Nagar, Dharkast Road, West Tambaram,Kanchipuram, Chennai-600044.",AD,Artificial Intelligence and DataScience,71,70,-1
1324,"Sri Sai Ram Institute of Technology (Autonomous), SaiLeo Nagar, Dharkast Road, West Tambaram,Kanchipuram, Chennai-600044.",AM,COMPUTER SCIENCE ANDENGINEERING (AI ANDMACHINE LEARNING),0,35,35
1324,"Sri Sai Ram Institute of Technology (Autonomous), SaiLeo Nagar, Dharkast Road, West Tambaram,Kanchipuram, Chennai-600044.",CI,Computer Science andEngineering (Internet of Things),0,35,35
1324,"Sri Sai Ram Institute of Technology (Autonomous), SaiLeo Nagar, Dharkast Road, West Tambaram,Kanchipuram, Chennai-600044.",CO,COMPUTER ANDCOMMUNICATIONENGINEERING,35,35,0
1324,"Sri Sai Ram Institute of Technology (Autonomous), SaiLeo Nagar, Dharkast Road, West Tambaram,Kanchipuram, Chennai-600044.",CS,COMPUTER SCIENCE ANDENGINEERING,140,142,2
1324,"Sri Sai Ram Institute of Technology (Autonomous), SaiLeo Nagar, Dharkast Road, West Tambaram,Kanchipuram, Chennai-600044.",EC,ELECTRONICS ANDCOMMUNICATIONENGINEERING,70,72,2
1324,"Sri Sai Ram Institute of Technology (Autonomous), SaiLeo Nagar, Dharkast Road, West Tambaram,Kanchipuram, Chennai-600044.",EE,ELECTRICAL AND ELECTRONICSENGINEERING,35,35,0
1324,"Sri Sai Ram Institute of Technology (Autonomous), SaiLeo Nagar, Dharkast Road, West Tambaram,Kanchipuram, Chennai-600044.",IT,INFORMATION TECHNOLOGY,106,105,-1
1324,"Sri Sai Ram Institute of Technology (Autonomous), SaiLeo Nagar, Dharkast Road, West Tambaram,Kanchipuram, Chennai-600044.",ME,MECHANICAL ENGINEERING,35,36,1
1324,"Sri Sai Ram Institute of Technology (Autonomous), SaiLeo Nagar, Dharkast Road, West Tambaram,Kanchipuram, Chennai-600044.",SC,Computer Science andEngineering (Cyber Security),35,36,1
1325,"St. Joseph College of Engineering, Trinity Campus,Nemili B Beemanthangal Village, Sriperumbudur,Kancheepuram District, Chennai-602105.",AD,Artificial Intelligence and DataScience,41,54,13
1325,"St. Joseph College of Engineering, Trinity Campus,Nemili B Beemanthangal Village, Sriperumbudur,Kancheepuram District, Chennai-602105.",CS,COMPUTER SCIENCE ANDENGINEERING,68,108,40
1325,"St. Joseph College of Engineering, Trinity Campus,Nemili B Beemanthangal Village, Sriperumbudur,Kancheepuram District, Chennai-602105.",EC,ELECTRONICS ANDCOMMUNICATIONENGINEERING,54,55,1
1325,"St. Joseph College of Engineering, Trinity Campus,Nemili B Beemanthangal Village, Sriperumbudur,Kancheepuram District, Chennai-602105.",IT,INFORMATION TECHNOLOGY,41,55,14
1325,"St. Joseph College of Engineering, Trinity Campus,Nemili B Beemanthangal Village, Sriperumbudur,Kancheepuram District, Chennai-602105.",ME,MECHANICAL ENGINEERING,53,55,2
1333,"Shikshaa Institute of Advanced Technologies(formerly Vi Institute of Technology), No. 96Sirunkundram Post,ChengalpattuTaluk,Kancheepuram District-603108.",AD,Artificial Intelligence and DataScience,0,35,35
1333,"Shikshaa Institute of Advanced Technologies(formerly Vi Institute of Technology), No. 96Sirunkundram Post,ChengalpattuTaluk,Kancheepuram District-603108.",AM,COMPUTER SCIENCE ANDENGINEERING (AI ANDMACHINE LEARNING),0,35,35
1333,"Shikshaa Institute of Advanced Technologies(formerly Vi Institute of Technology), No. 96Sirunkundram Post,ChengalpattuTaluk,Kancheepuram District-603108.",CS,COMPUTER SCIENCE ANDENGINEERING,0,36,36
1333,"Shikshaa Institute of Advanced Technologies(formerly Vi Institute of Technology), No. 96Sirunkundram Post,ChengalpattuTaluk,Kancheepuram District-603108.",EC,ELECTRONICS ANDCOMMUNICATIONENGINEERING,0,36,36
1333,"Shikshaa Institute of Advanced Technologies(formerly Vi Institute of Technology), No. 96Sirunkundram Post,ChengalpattuTaluk,Kancheepuram District-603108.",EE,ELECTRICAL AND ELECTRONICSENGINEERING,0,18,18
1333,"Shikshaa Institute of Advanced Technologies(formerly Vi Institute of Technology), No. 96Sirunkundram Post,ChengalpattuTaluk,Kancheepuram District-603108.",ME,MECHANICAL ENGINEERING,0,35,35
1334,ARS College of Engineering  Maraimalai Nagar PostChengalpattu District 603209,CE,CIVIL  ENGINEERING,70,0,-70
1334,ARS College of Engineering  Maraimalai Nagar PostChengalpattu District 603209,CS,COMPUTER SCIENCE ANDENGINEERING,18,0,-18
1334,ARS College of Engineering  Maraimalai Nagar PostChengalpattu District 603209,EC,ELECTRONICS ANDCOMMUNICATIONENGINEERING,35,0,-35
1334,ARS College of Engineering  Maraimalai Nagar PostChengalpattu District 603209,ME,MECHANICAL ENGINEERING,71,0,-71
1335,"Sri Krishna Institute of Technology, NavaneedamNagar, Panapakkam, Near Padappai, Kanchipuram-601301.",AM,COMPUTER SCIENCE ANDENGINEERING (AI ANDMACHINE LEARNING),54,54,0
1335,"Sri Krishna Institute of Technology, NavaneedamNagar, Panapakkam, Near Padappai, Kanchipuram-601301.",CE,CIVIL  ENGINEERING,54,55,1
1335,"Sri Krishna Institute of Technology, NavaneedamNagar, Panapakkam, Near Padappai, Kanchipuram-601301.",EC,ELECTRONICS ANDCOMMUNICATIONENGINEERING,27,27,0
1335,"Sri Krishna Institute of Technology, NavaneedamNagar, Panapakkam, Near Padappai, Kanchipuram-601301.",EE,ELECTRICAL AND ELECTRONICSENGINEERING,20,20,0
1335,"Sri Krishna Institute of Technology, NavaneedamNagar, Panapakkam, Near Padappai, Kanchipuram-601301.",ME,MECHANICAL ENGINEERING,54,54,0
1335,"Sri Krishna Institute of Technology, NavaneedamNagar, Panapakkam, Near Padappai, Kanchipuram-601301.",SC,Computer Science andEngineering (Cyber Security),54,55,1
1339,"Mahalakshmi Tech Campus (formerly MahalakshmiEngineering College), No.1 Bharathiyar Street,Prashanthi Nagar, Chromepet,Chennai-600044.",AD,Artificial Intelligence and DataScience,0,53,53
1339,"Mahalakshmi Tech Campus (formerly MahalakshmiEngineering College), No.1 Bharathiyar Street,Prashanthi Nagar, Chromepet,Chennai-600044.",CE,CIVIL  ENGINEERING,0,55,55
1339,"Mahalakshmi Tech Campus (formerly MahalakshmiEngineering College), No.1 Bharathiyar Street,Prashanthi Nagar, Chromepet,Chennai-600044.",CS,COMPUTER SCIENCE ANDENGINEERING,0,55,55
1339,"Mahalakshmi Tech Campus (formerly MahalakshmiEngineering College), No.1 Bharathiyar Street,Prashanthi Nagar, Chromepet,Chennai-600044.",EC,ELECTRONICS ANDCOMMUNICATIONENGINEERING,0,54,54
1339,"Mahalakshmi Tech Campus (formerly MahalakshmiEngineering College), No.1 Bharathiyar Street,Prashanthi Nagar, Chromepet,Chennai-600044.",EE,ELECTRICAL AND ELECTRONICSENGINEERING,0,54,54
1339,"Mahalakshmi Tech Campus (formerly MahalakshmiEngineering College), No.1 Bharathiyar Street,Prashanthi Nagar, Chromepet,Chennai-600044.",ME,MECHANICAL ENGINEERING,0,55,55
1398,Chennai Institute of Technology and Applied ResearchSarathy Nagar  Puthuper Village  KundrathurChennai 600069,AD,ARTIFICIAL INTELLIGENCEAND DATA SCIENCE,34,0,-34
1398,Chennai Institute of Technology and Applied ResearchSarathy Nagar  Puthuper Village  KundrathurChennai 600069,CS,COMPUTER SCIENCE ANDENGINEERING,105,0,-105
1398,Chennai Institute of Technology and Applied ResearchSarathy Nagar  Puthuper Village  KundrathurChennai 600069,EC,ELECTRONICS ANDCOMMUNICATIONENGINEERING,35,0,-35
1398,Chennai Institute of Technology and Applied ResearchSarathy Nagar  Puthuper Village  KundrathurChennai 600069,EE,ELECTRICAL ANDELECTRONICS ENGINEERING,35,0,-35
1399,Chennai Institute of Technology (Autonomous)Puduper Village  Nandambakkam Post  KundrathurChennai 600069,AD,Artificial Intelligence and DataScience,68,136,68
1399,Chennai Institute of Technology (Autonomous)Puduper Village  Nandambakkam Post  KundrathurChennai 600069,AM,COMPUTER SCIENCE ANDENGINEERING (AI ANDMACHINE LEARNING),54,54,0
1399,Chennai Institute of Technology (Autonomous)Puduper Village  Nandambakkam Post  KundrathurChennai 600069,BM,BIO MEDICAL ENGINEERING,27,27,0
1399,Chennai Institute of Technology (Autonomous)Puduper Village  Nandambakkam Post  KundrathurChennai 600069,CB,COMPUTER SCIENCE ANDBUSSINESS SYSTEM,26,27,1
1399,Chennai Institute of Technology (Autonomous)Puduper Village  Nandambakkam Post  KundrathurChennai 600069,CE,CIVIL  ENGINEERING,14,14,0
1399,Chennai Institute of Technology (Autonomous)Puduper Village  Nandambakkam Post  KundrathurChennai 600069,CS,COMPUTER SCIENCE ANDENGINEERING,106,435,329
1399,Chennai Institute of Technology (Autonomous)Puduper Village  Nandambakkam Post  KundrathurChennai 600069,EA,Electronics and Communication(Advanced CommunicationTechnology),27,27,0
1399,Chennai Institute of Technology (Autonomous)Puduper Village  Nandambakkam Post  KundrathurChennai 600069,EC,ELECTRONICS ANDCOMMUNICATIONENGINEERING,81,109,28
1399,Chennai Institute of Technology (Autonomous)Puduper Village  Nandambakkam Post  KundrathurChennai 600069,EE,ELECTRICAL AND ELECTRONICSENGINEERING,26,27,1
1399,Chennai Institute of Technology (Autonomous)Puduper Village  Nandambakkam Post  KundrathurChennai 600069,EV,Electronics Engineering (VLSIDesign and Technology),28,28,0
1399,Chennai Institute of Technology (Autonomous)Puduper Village  Nandambakkam Post  KundrathurChennai 600069,IT,INFORMATION TECHNOLOGY,81,81,0
1399,Chennai Institute of Technology (Autonomous)Puduper Village  Nandambakkam Post  KundrathurChennai 600069,ME,MECHANICAL ENGINEERING,55,54,-1
1399,Chennai Institute of Technology (Autonomous)Puduper Village  Nandambakkam Post  KundrathurChennai 600069,MZ,Mechatronics Engineering,27,27,0
1399,Chennai Institute of Technology (Autonomous)Puduper Village  Nandambakkam Post  KundrathurChennai 600069,SC,Computer Science andEngineering (Cyber Security),27,28,1
1400,"Mohamed Sathak A.J. Academy of Architecture, ITHighway, 34, Old Mahabalipuram Road, Egattur,Chenglepet Taluk, Kancheepuram District-603103.",DA,Bachelor of Design,0,14,14
1401,"Adhiparasakthi Engineering College, Melmaruvathur,Cheyyur Taluk, Kancheepuram District-603319.",AM,COMPUTER SCIENCE ANDENGINEERING (AI ANDMACHINE LEARNING),18,17,-1
1401,"Adhiparasakthi Engineering College, Melmaruvathur,Cheyyur Taluk, Kancheepuram District-603319.",CE,CIVIL  ENGINEERING,50,50,0
1401,"Adhiparasakthi Engineering College, Melmaruvathur,Cheyyur Taluk, Kancheepuram District-603319.",CH,CHEMICAL  ENGINEERING,31,32,1
1401,"Adhiparasakthi Engineering College, Melmaruvathur,Cheyyur Taluk, Kancheepuram District-603319.",CS,COMPUTER SCIENCE ANDENGINEERING,54,54,0
1401,"Adhiparasakthi Engineering College, Melmaruvathur,Cheyyur Taluk, Kancheepuram District-603319.",EC,ELECTRONICS ANDCOMMUNICATIONENGINEERING,60,60,0
1401,"Adhiparasakthi Engineering College, Melmaruvathur,Cheyyur Taluk, Kancheepuram District-603319.",EE,ELECTRICAL AND ELECTRONICSENGINEERING,44,45,1
1401,"Adhiparasakthi Engineering College, Melmaruvathur,Cheyyur Taluk, Kancheepuram District-603319.",IT,INFORMATION TECHNOLOGY,35,35,0
1401,"Adhiparasakthi Engineering College, Melmaruvathur,Cheyyur Taluk, Kancheepuram District-603319.",ME,MECHANICAL ENGINEERING,50,50,0
1402,"Annai Teresa College of Engineering, Thirunavalur,Ulundurpet Taluk, Villupuram District-607204.",CS,COMPUTER SCIENCE ANDENGINEERING,36,35,-1
1402,"Annai Teresa College of Engineering, Thirunavalur,Ulundurpet Taluk, Villupuram District-607204.",EC,ELECTRONICS ANDCOMMUNICATIONENGINEERING,35,36,1
1402,"Annai Teresa College of Engineering, Thirunavalur,Ulundurpet Taluk, Villupuram District-607204.",EE,ELECTRICAL AND ELECTRONICSENGINEERING,35,35,0
1402,"Annai Teresa College of Engineering, Thirunavalur,Ulundurpet Taluk, Villupuram District-607204.",ME,MECHANICAL ENGINEERING,35,36,1
1405,"Dhanalakshmi College of Engineering, ManimangalamPuducheri Road, Manimangalam, ManimangalamPost, Sriperumbudur Taluk, Kancheepuram District,Chennai-601301.",AD,Artificial Intelligence and DataScience,70,70,0
1405,"Dhanalakshmi College of Engineering, ManimangalamPuducheri Road, Manimangalam, ManimangalamPost, Sriperumbudur Taluk, Kancheepuram District,Chennai-601301.",AM,COMPUTER SCIENCE ANDENGINEERING (AI ANDMACHINE LEARNING),0,35,35
1405,"Dhanalakshmi College of Engineering, ManimangalamPuducheri Road, Manimangalam, ManimangalamPost, Sriperumbudur Taluk, Kancheepuram District,Chennai-601301.",CS,COMPUTER SCIENCE ANDENGINEERING,69,71,2
1405,"Dhanalakshmi College of Engineering, ManimangalamPuducheri Road, Manimangalam, ManimangalamPost, Sriperumbudur Taluk, Kancheepuram District,Chennai-601301.",EC,ELECTRONICS ANDCOMMUNICATIONENGINEERING,45,35,-10
1405,"Dhanalakshmi College of Engineering, ManimangalamPuducheri Road, Manimangalam, ManimangalamPost, Sriperumbudur Taluk, Kancheepuram District,Chennai-601301.",EE,ELECTRICAL AND ELECTRONICSENGINEERING,22,19,-3
1405,"Dhanalakshmi College of Engineering, ManimangalamPuducheri Road, Manimangalam, ManimangalamPost, Sriperumbudur Taluk, Kancheepuram District,Chennai-601301.",IT,INFORMATION TECHNOLOGY,0,35,35
1405,"Dhanalakshmi College of Engineering, ManimangalamPuducheri Road, Manimangalam, ManimangalamPost, Sriperumbudur Taluk, Kancheepuram District,Chennai-601301.",ME,MECHANICAL ENGINEERING,22,18,-4
1405,"Dhanalakshmi College of Engineering, ManimangalamPuducheri Road, Manimangalam, ManimangalamPost, Sriperumbudur Taluk, Kancheepuram District,Chennai-601301.",SC,Computer Science andEngineering (Cyber Security),35,35,0
1407,"G K M College of Engineering and Technology, G K MNagar, Alappakkam-Mappedu Road, NewPerugalathur, Chennai-600063.",AD,Artificial Intelligence and DataScience,18,35,17
1407,"G K M College of Engineering and Technology, G K MNagar, Alappakkam-Mappedu Road, NewPerugalathur, Chennai-600063.",AU,AUTOMOBILE ENGINEERING,18,17,-1
1407,"G K M College of Engineering and Technology, G K MNagar, Alappakkam-Mappedu Road, NewPerugalathur, Chennai-600063.",BM,BIO MEDICAL ENGINEERING,18,17,-1
1407,"G K M College of Engineering and Technology, G K MNagar, Alappakkam-Mappedu Road, NewPerugalathur, Chennai-600063.",CE,CIVIL  ENGINEERING,18,18,0
1407,"G K M College of Engineering and Technology, G K MNagar, Alappakkam-Mappedu Road, NewPerugalathur, Chennai-600063.",CS,COMPUTER SCIENCE ANDENGINEERING,35,36,1
1407,"G K M College of Engineering and Technology, G K MNagar, Alappakkam-Mappedu Road, NewPerugalathur, Chennai-600063.",EC,ELECTRONICS ANDCOMMUNICATIONENGINEERING,18,18,0
1407,"G K M College of Engineering and Technology, G K MNagar, Alappakkam-Mappedu Road, NewPerugalathur, Chennai-600063.",EE,ELECTRICAL AND ELECTRONICSENGINEERING,17,18,1
1407,"G K M College of Engineering and Technology, G K MNagar, Alappakkam-Mappedu Road, NewPerugalathur, Chennai-600063.",IT,INFORMATION TECHNOLOGY,17,18,1
1407,"G K M College of Engineering and Technology, G K MNagar, Alappakkam-Mappedu Road, NewPerugalathur, Chennai-600063.",ME,MECHANICAL ENGINEERING,17,18,1
1407,"G K M College of Engineering and Technology, G K MNagar, Alappakkam-Mappedu Road, NewPerugalathur, Chennai-600063.",MR,MARINE ENGINEERING,17,18,1
1407,"G K M College of Engineering and Technology, G K MNagar, Alappakkam-Mappedu Road, NewPerugalathur, Chennai-600063.",SC,Computer Science andEngineering (Cyber Security),0,17,17
1408,"IFET College of Engineering (Autonomous), IFETNagar, Gangarampalayam, Valavanur Post,Villupuram District-605108.",AD,Artificial Intelligence and DataScience,35,71,36
1408,"IFET College of Engineering (Autonomous), IFETNagar, Gangarampalayam, Valavanur Post,Villupuram District-605108.",AL,Artificial Intelligence andMachine Learning,36,36,0
1408,I F E T College of Engineering  (Autonomous)Gangarampalayam  Villupuram District 605108,CE,CIVIL  ENGINEERING,19,0,-19
1408,"IFET College of Engineering (Autonomous), IFETNagar, Gangarampalayam, Valavanur Post,Villupuram District-605108.",CS,COMPUTER SCIENCE ANDENGINEERING,105,105,0
1408,"IFET College of Engineering (Autonomous), IFETNagar, Gangarampalayam, Valavanur Post,Villupuram District-605108.",EC,ELECTRONICS ANDCOMMUNICATIONENGINEERING,71,105,34
1408,"IFET College of Engineering (Autonomous), IFETNagar, Gangarampalayam, Valavanur Post,Villupuram District-605108.",EE,ELECTRICAL AND ELECTRONICSENGINEERING,35,36,1
1408,"IFET College of Engineering (Autonomous), IFETNagar, Gangarampalayam, Valavanur Post,Villupuram District-605108.",IT,INFORMATION TECHNOLOGY,34,70,36
1408,"IFET College of Engineering (Autonomous), IFETNagar, Gangarampalayam, Valavanur Post,Villupuram District-605108.",ME,MECHANICAL ENGINEERING,35,36,1
1408,"IFET College of Engineering (Autonomous), IFETNagar, Gangarampalayam, Valavanur Post,Villupuram District-605108.",SC,Computer Science andEngineering (Cyber Security),35,36,1
1409,"Karpaga Vinayaga College of Engineering andTechnology, G.S.T. Road, Chinna Kolambakkam,Palayanoor Post, Madurantagam Taluk,Kancheepuram Dist-603308.",AD,Artificial Intelligence and DataScience,34,36,2
1409,"Karpaga Vinayaga College of Engineering andTechnology, G.S.T. Road, Chinna Kolambakkam,Palayanoor Post, Madurantagam Taluk,Kancheepuram Dist-603308.",AU,AUTOMOBILE ENGINEERING,20,26,6
1409,"Karpaga Vinayaga College of Engineering andTechnology, G.S.T. Road, Chinna Kolambakkam,Palayanoor Post, Madurantagam Taluk,Kancheepuram Dist-603308.",BM,BIO MEDICAL ENGINEERING,35,35,0
1409,"Karpaga Vinayaga College of Engineering andTechnology, G.S.T. Road, Chinna Kolambakkam,Palayanoor Post, Madurantagam Taluk,Kancheepuram Dist-603308.",BT,BIO TECHNOLOGY,35,35,0
1409,"Karpaga Vinayaga College of Engineering andTechnology, G.S.T. Road, Chinna Kolambakkam,Palayanoor Post, Madurantagam Taluk,Kancheepuram Dist-603308.",CE,CIVIL  ENGINEERING,18,26,8
1409,"Karpaga Vinayaga College of Engineering andTechnology, G.S.T. Road, Chinna Kolambakkam,Palayanoor Post, Madurantagam Taluk,Kancheepuram Dist-603308.",CS,COMPUTER SCIENCE ANDENGINEERING,53,71,18
1409,"Karpaga Vinayaga College of Engineering andTechnology, G.S.T. Road, Chinna Kolambakkam,Palayanoor Post, Madurantagam Taluk,Kancheepuram Dist-603308.",EC,ELECTRONICS ANDCOMMUNICATIONENGINEERING,18,37,19
1409,"Karpaga Vinayaga College of Engineering andTechnology, G.S.T. Road, Chinna Kolambakkam,Palayanoor Post, Madurantagam Taluk,Kancheepuram Dist-603308.",EE,ELECTRICAL AND ELECTRONICSENGINEERING,20,18,-2
1409,"Karpaga Vinayaga College of Engineering andTechnology, G.S.T. Road, Chinna Kolambakkam,Palayanoor Post, Madurantagam Taluk,Kancheepuram Dist-603308.",ME,MECHANICAL ENGINEERING,18,18,0
1409,"Karpaga Vinayaga College of Engineering andTechnology, G.S.T. Road, Chinna Kolambakkam,Palayanoor Post, Madurantagam Taluk,Kancheepuram Dist-603308.",RM,ROBOTICS AND AUTOMATION,35,35,0
1411,"Madha Engineering College, MadhaNagar,Somangalam Road, Kundrathur, Kanchipuram,Chennai-600069.",AD,Artificial Intelligence and DataScience,18,18,0
1411,"Madha Engineering College, MadhaNagar,Somangalam Road, Kundrathur, Kanchipuram,Chennai-600069.",AE,AERONAUTICAL ENGINEERING,18,14,-4
1411,"Madha Engineering College, MadhaNagar,Somangalam Road, Kundrathur, Kanchipuram,Chennai-600069.",AM,COMPUTER SCIENCE ANDENGINEERING (AI ANDMACHINE LEARNING),0,14,14
1411,"Madha Engineering College, MadhaNagar,Somangalam Road, Kundrathur, Kanchipuram,Chennai-600069.",BM,BIO MEDICAL ENGINEERING,18,14,-4
1411,"Madha Engineering College, MadhaNagar,Somangalam Road, Kundrathur, Kanchipuram,Chennai-600069.",BT,BIO TECHNOLOGY,14,14,0
1411,"Madha Engineering College, MadhaNagar,Somangalam Road, Kundrathur, Kanchipuram,Chennai-600069.",CB,COMPUTER SCIENCE ANDBUSSINESS SYSTEM,14,14,0
1411,Madha Engineering College  Kundrathur  Chennai600069,CE,CIVIL  ENGINEERING,13,0,-13
1411,"Madha Engineering College, MadhaNagar,Somangalam Road, Kundrathur, Kanchipuram,Chennai-600069.",CS,COMPUTER SCIENCE ANDENGINEERING,26,27,1
1411,"Madha Engineering College, MadhaNagar,Somangalam Road, Kundrathur, Kanchipuram,Chennai-600069.",EC,ELECTRONICS ANDCOMMUNICATIONENGINEERING,18,13,-5
1411,"Madha Engineering College, MadhaNagar,Somangalam Road, Kundrathur, Kanchipuram,Chennai-600069.",EE,ELECTRICAL AND ELECTRONICSENGINEERING,14,13,-1
1411,"Madha Engineering College, MadhaNagar,Somangalam Road, Kundrathur, Kanchipuram,Chennai-600069.",IT,INFORMATION TECHNOLOGY,18,13,-5
1411,"Madha Engineering College, MadhaNagar,Somangalam Road, Kundrathur, Kanchipuram,Chennai-600069.",ME,MECHANICAL ENGINEERING,14,14,0
1412,"Mailam Engineering College, Mailam, TindivanamTaluk, Villupuram District-604304.",AD,Artificial Intelligence and DataScience,34,107,73
1412,"Mailam Engineering College, Mailam, TindivanamTaluk, Villupuram District-604304.",CB,COMPUTER SCIENCE ANDBUSSINESS SYSTEM,55,54,-1
1412,"Mailam Engineering College, Mailam, TindivanamTaluk, Villupuram District-604304.",CE,CIVIL  ENGINEERING,55,54,-1
1412,"Mailam Engineering College, Mailam, TindivanamTaluk, Villupuram District-604304.",CS,COMPUTER SCIENCE ANDENGINEERING,106,142,36
1412,"Mailam Engineering College, Mailam, TindivanamTaluk, Villupuram District-604304.",EC,ELECTRONICS ANDCOMMUNICATIONENGINEERING,163,153,-10
1412,"Mailam Engineering College, Mailam, TindivanamTaluk, Villupuram District-604304.",EE,ELECTRICAL AND ELECTRONICSENGINEERING,55,54,-1
1412,"Mailam Engineering College, Mailam, TindivanamTaluk, Villupuram District-604304.",IT,INFORMATION TECHNOLOGY,70,72,2
1412,"Mailam Engineering College, Mailam, TindivanamTaluk, Villupuram District-604304.",ME,MECHANICAL ENGINEERING,109,109,0
1413,"Sri Venkateswaraa College of Technology,Sirukulathur, Vadakal Village, Mathur Post,Sriperumbhudur, Kanchipuram-602105.",AD,Artificial Intelligence and DataScience,34,91,57
1413,"Sri Venkateswaraa College of Technology,Sirukulathur, Vadakal Village, Mathur Post,Sriperumbhudur, Kanchipuram-602105.",AM,COMPUTER SCIENCE ANDENGINEERING (AI ANDMACHINE LEARNING),0,98,98
1413,"Sri Venkateswaraa College of Technology,Sirukulathur, Vadakal Village, Mathur Post,Sriperumbhudur, Kanchipuram-602105.",CB,COMPUTER SCIENCE ANDBUSSINESS SYSTEM,0,50,50
1413,"Sri Venkateswaraa College of Technology,Sirukulathur, Vadakal Village, Mathur Post,Sriperumbhudur, Kanchipuram-602105.",CD,COMPUTER SCIENCE ANDDESIGN,0,50,50
1413,"Sri Venkateswaraa College of Technology,Sirukulathur, Vadakal Village, Mathur Post,Sriperumbhudur, Kanchipuram-602105.",CS,COMPUTER SCIENCE ANDENGINEERING,53,91,38
1413,"Sri Venkateswaraa College of Technology,Sirukulathur, Vadakal Village, Mathur Post,Sriperumbhudur, Kanchipuram-602105.",EA,Electronics and Communication(Advanced CommunicationTechnology),0,50,50
1413,"Sri Venkateswaraa College of Technology,Sirukulathur, Vadakal Village, Mathur Post,Sriperumbhudur, Kanchipuram-602105.",EC,ELECTRONICS ANDCOMMUNICATIONENGINEERING,35,50,15
1413,"Sri Venkateswaraa College of Technology,Sirukulathur, Vadakal Village, Mathur Post,Sriperumbhudur, Kanchipuram-602105.",EE,ELECTRICAL AND ELECTRONICSENGINEERING,28,28,0
1413,"Sri Venkateswaraa College of Technology,Sirukulathur, Vadakal Village, Mathur Post,Sriperumbhudur, Kanchipuram-602105.",EV,Electronics Engineering (VLSIDesign and Technology),0,50,50
1413,"Sri Venkateswaraa College of Technology,Sirukulathur, Vadakal Village, Mathur Post,Sriperumbhudur, Kanchipuram-602105.",IT,INFORMATION TECHNOLOGY,0,50,50
1413,"Sri Venkateswaraa College of Technology,Sirukulathur, Vadakal Village, Mathur Post,Sriperumbhudur, Kanchipuram-602105.",ME,MECHANICAL ENGINEERING,27,28,1
1413,"Sri Venkateswaraa College of Technology,Sirukulathur, Vadakal Village, Mathur Post,Sriperumbhudur, Kanchipuram-602105.",SC,Computer Science andEngineering (Cyber Security),35,98,63
1414,"Prince Shri Venkateshwaraa Padmavathy EngineeringCollege (Autonomous), Medavakkam - MambakkamRoad, Ponmar, Kanchipuram, Chennai-600127.",CE,CIVIL  ENGINEERING,18,18,0
1414,"Prince Shri Venkateshwaraa Padmavathy EngineeringCollege (Autonomous), Medavakkam - MambakkamRoad, Ponmar, Kanchipuram, Chennai-600127.",CS,COMPUTER SCIENCE ANDENGINEERING,34,36,2
1414,"Prince Shri Venkateshwaraa Padmavathy EngineeringCollege (Autonomous), Medavakkam - MambakkamRoad, Ponmar, Kanchipuram, Chennai-600127.",EC,ELECTRONICS ANDCOMMUNICATIONENGINEERING,70,70,0
1414,"Prince Shri Venkateshwaraa Padmavathy EngineeringCollege (Autonomous), Medavakkam - MambakkamRoad, Ponmar, Kanchipuram, Chennai-600127.",EE,ELECTRICAL AND ELECTRONICSENGINEERING,18,18,0
1414,"Prince Shri Venkateshwaraa Padmavathy EngineeringCollege (Autonomous), Medavakkam - MambakkamRoad, Ponmar, Kanchipuram, Chennai-600127.",IT,INFORMATION TECHNOLOGY,35,35,0
1414,"Prince Shri Venkateshwaraa Padmavathy EngineeringCollege (Autonomous), Medavakkam - MambakkamRoad, Ponmar, Kanchipuram, Chennai-600127.",ME,MECHANICAL ENGINEERING,35,17,-18
1415,"T.S.M.Jain College of Technology, Melur,KallakurichiTaluk,Villupuram District-606201.",CE,CIVIL  ENGINEERING,35,44,9
1415,"T.S.M.Jain College of Technology, Melur,KallakurichiTaluk,Villupuram District-606201.",CS,COMPUTER SCIENCE ANDENGINEERING,19,23,4
1415,"T.S.M.Jain College of Technology, Melur,KallakurichiTaluk,Villupuram District-606201.",EC,ELECTRONICS ANDCOMMUNICATIONENGINEERING,18,22,4
1415,"T.S.M.Jain College of Technology, Melur,KallakurichiTaluk,Villupuram District-606201.",EE,ELECTRICAL AND ELECTRONICSENGINEERING,35,44,9
1415,"T.S.M.Jain College of Technology, Melur,KallakurichiTaluk,Villupuram District-606201.",ME,MECHANICAL ENGINEERING,35,44,9
1416,"Jaya Sakthi Engineering College, St.Mary's Nagar,Thiruninravur,(Near Avadi), Thiruvallur, Chennai-602024.",AD,Artificial Intelligence and DataScience,49,49,0
1416,"Jaya Sakthi Engineering College, St.Mary's Nagar,Thiruninravur,(Near Avadi), Thiruvallur, Chennai-602024.",BM,BIO MEDICAL ENGINEERING,49,49,0
1416,"Jaya Sakthi Engineering College, St.Mary's Nagar,Thiruninravur,(Near Avadi), Thiruvallur, Chennai-602024.",BT,BIO TECHNOLOGY,0,25,25
1416,"Jaya Sakthi Engineering College, St.Mary's Nagar,Thiruninravur,(Near Avadi), Thiruvallur, Chennai-602024.",CS,COMPUTER SCIENCE ANDENGINEERING,45,45,0
1416,"Jaya Sakthi Engineering College, St.Mary's Nagar,Thiruninravur,(Near Avadi), Thiruvallur, Chennai-602024.",ME,MECHANICAL ENGINEERING,49,49,0
1416,"Jaya Sakthi Engineering College, St.Mary's Nagar,Thiruninravur,(Near Avadi), Thiruvallur, Chennai-602024.",PH,PHARMACEUTICALTECHNOLOGY,49,24,-25
1416,"Jaya Sakthi Engineering College, St.Mary's Nagar,Thiruninravur,(Near Avadi), Thiruvallur, Chennai-602024.",SC,Computer Science andEngineering (Cyber Security),45,49,4
1419,"Sri Sai Ram Engineering College (Autonomous), SaiLeo Nagar, Poonthandalam Village, Dharkast Post,West Tambram, Kanchipuram, Chennai-600044.",AD,Artificial Intelligence and DataScience,107,105,-2
1419,"Sri Sai Ram Engineering College (Autonomous), SaiLeo Nagar, Poonthandalam Village, Dharkast Post,West Tambram, Kanchipuram, Chennai-600044.",AM,COMPUTER SCIENCE ANDENGINEERING (AI ANDMACHINE LEARNING),70,71,1
1419,"Sri Sai Ram Engineering College (Autonomous), SaiLeo Nagar, Poonthandalam Village, Dharkast Post,West Tambram, Kanchipuram, Chennai-600044.",CB,COMPUTER SCIENCE ANDBUSSINESS SYSTEM,69,70,1
1419,"Sri Sai Ram Engineering College (Autonomous), SaiLeo Nagar, Poonthandalam Village, Dharkast Post,West Tambram, Kanchipuram, Chennai-600044.",CE,CIVIL  ENGINEERING,35,40,5
1419,"Sri Sai Ram Engineering College (Autonomous), SaiLeo Nagar, Poonthandalam Village, Dharkast Post,West Tambram, Kanchipuram, Chennai-600044.",CI,Computer Science andEngineering (Internet of Things),35,35,0
1419,"Sri Sai Ram Engineering College (Autonomous), SaiLeo Nagar, Poonthandalam Village, Dharkast Post,West Tambram, Kanchipuram, Chennai-600044.",CJ,M.Tech. Computer Science andEngineering (Integrated 5years),35,35,0
1419,"Sri Sai Ram Engineering College (Autonomous), SaiLeo Nagar, Poonthandalam Village, Dharkast Post,West Tambram, Kanchipuram, Chennai-600044.",CS,COMPUTER SCIENCE ANDENGINEERING,141,142,1
1419,"Sri Sai Ram Engineering College (Autonomous), SaiLeo Nagar, Poonthandalam Village, Dharkast Post,West Tambram, Kanchipuram, Chennai-600044.",EC,ELECTRONICS ANDCOMMUNICATIONENGINEERING,141,142,1
1419,"Sri Sai Ram Engineering College (Autonomous), SaiLeo Nagar, Poonthandalam Village, Dharkast Post,West Tambram, Kanchipuram, Chennai-600044.",EE,ELECTRICAL AND ELECTRONICSENGINEERING,71,71,0
1419,"Sri Sai Ram Engineering College (Autonomous), SaiLeo Nagar, Poonthandalam Village, Dharkast Post,West Tambram, Kanchipuram, Chennai-600044.",EI,ELECTRONICS ANDINSTRUMENTATIONENGINEERING,54,52,-2
1419,Sri Sai Ram Enginering College (Autonomous)  WestTambaram  Chennai 600044,IC,INSTRUMENTATION ANDCONTROL ENGINEERING,18,0,-18
1419,"Sri Sai Ram Engineering College (Autonomous), SaiLeo Nagar, Poonthandalam Village, Dharkast Post,West Tambram, Kanchipuram, Chennai-600044.",IT,INFORMATION TECHNOLOGY,105,106,1
1419,"Sri Sai Ram Engineering College (Autonomous), SaiLeo Nagar, Poonthandalam Village, Dharkast Post,West Tambram, Kanchipuram, Chennai-600044.",IX,Electronic Instrumentation andControl Engineering,0,36,36
1419,"Sri Sai Ram Engineering College (Autonomous), SaiLeo Nagar, Poonthandalam Village, Dharkast Post,West Tambram, Kanchipuram, Chennai-600044.",ME,MECHANICAL ENGINEERING,70,70,0
1419,"Sri Sai Ram Engineering College (Autonomous), SaiLeo Nagar, Poonthandalam Village, Dharkast Post,West Tambram, Kanchipuram, Chennai-600044.",MU,MECHANICAL ANDAUTOMATION ENGINEERING,35,36,1
1419,"Sri Sai Ram Engineering College (Autonomous), SaiLeo Nagar, Poonthandalam Village, Dharkast Post,West Tambram, Kanchipuram, Chennai-600044.",SC,Computer Science andEngineering (Cyber Security),0,36,36
1420,"Tagore Engineering College, Rathinamangalam,Vandalur, Kanchipuram, Chennai-600127.",AD,Artificial Intelligence and DataScience,35,35,0
1420,"Tagore Engineering College, Rathinamangalam,Vandalur, Kanchipuram, Chennai-600127.",AE,AERONAUTICAL ENGINEERING,21,20,-1
1420,"Tagore Engineering College, Rathinamangalam,Vandalur, Kanchipuram, Chennai-600127.",CS,COMPUTER SCIENCE ANDENGINEERING,69,70,1
1420,"Tagore Engineering College, Rathinamangalam,Vandalur, Kanchipuram, Chennai-600127.",EC,ELECTRONICS ANDCOMMUNICATIONENGINEERING,35,35,0
1420,"Tagore Engineering College, Rathinamangalam,Vandalur, Kanchipuram, Chennai-600127.",IT,INFORMATION TECHNOLOGY,35,35,0
1420,"Tagore Engineering College, Rathinamangalam,Vandalur, Kanchipuram, Chennai-600127.",ME,MECHANICAL ENGINEERING,22,21,-1
1420,"Tagore Engineering College, Rathinamangalam,Vandalur, Kanchipuram, Chennai-600127.",SC,Computer Science andEngineering (Cyber Security),0,35,35
1421,"V.R.S. College of Engineering and Technology, Arasur& Post, Ulundurpet Taluk, Villupuram District-607107.",CE,CIVIL  ENGINEERING,54,53,-1
1421,"V.R.S. College of Engineering and Technology, Arasur& Post, Ulundurpet Taluk, Villupuram District-607107.",CS,COMPUTER SCIENCE ANDENGINEERING,91,86,-5
1421,"V.R.S. College of Engineering and Technology, Arasur& Post, Ulundurpet Taluk, Villupuram District-607107.",EC,ELECTRONICS ANDCOMMUNICATIONENGINEERING,55,55,0
1421,"V.R.S. College of Engineering and Technology, Arasur& Post, Ulundurpet Taluk, Villupuram District-607107.",EE,ELECTRICAL AND ELECTRONICSENGINEERING,55,51,-4
1421,"V.R.S. College of Engineering and Technology, Arasur& Post, Ulundurpet Taluk, Villupuram District-607107.",IT,INFORMATION TECHNOLOGY,0,41,41
1421,"V.R.S. College of Engineering and Technology, Arasur& Post, Ulundurpet Taluk, Villupuram District-607107.",ME,MECHANICAL ENGINEERING,108,54,-54
1422,"SRM Valliammai Engineering College (Autonomous),S.R.M. Nagar, Kattankulathur, Chengalpattu,Kancheepuram, Chennai-603203.",AD,Artificial Intelligence and DataScience,28,55,27
1422,"SRM Valliammai Engineering College (Autonomous),S.R.M. Nagar, Kattankulathur, Chengalpattu,Kancheepuram, Chennai-603203.",AG,AGRICULTURE ENGINEERING,54,54,0
1422,"SRM Valliammai Engineering College (Autonomous),S.R.M. Nagar, Kattankulathur, Chengalpattu,Kancheepuram, Chennai-603203.",CE,CIVIL  ENGINEERING,27,27,0
1422,"SRM Valliammai Engineering College (Autonomous),S.R.M. Nagar, Kattankulathur, Chengalpattu,Kancheepuram, Chennai-603203.",CS,COMPUTER SCIENCE ANDENGINEERING,79,81,2
1422,"SRM Valliammai Engineering College (Autonomous),S.R.M. Nagar, Kattankulathur, Chengalpattu,Kancheepuram, Chennai-603203.",CY,Cyber Security,27,27,0
1422,"SRM Valliammai Engineering College (Autonomous),S.R.M. Nagar, Kattankulathur, Chengalpattu,Kancheepuram, Chennai-603203.",EC,ELECTRONICS ANDCOMMUNICATIONENGINEERING,81,81,0
1422,"SRM Valliammai Engineering College (Autonomous),S.R.M. Nagar, Kattankulathur, Chengalpattu,Kancheepuram, Chennai-603203.",EE,ELECTRICAL AND ELECTRONICSENGINEERING,41,41,0
1422,"SRM Valliammai Engineering College (Autonomous),S.R.M. Nagar, Kattankulathur, Chengalpattu,Kancheepuram, Chennai-603203.",EI,ELECTRONICS ANDINSTRUMENTATIONENGINEERING,45,50,5
1422,"SRM Valliammai Engineering College (Autonomous),S.R.M. Nagar, Kattankulathur, Chengalpattu,Kancheepuram, Chennai-603203.",IT,INFORMATION TECHNOLOGY,55,54,-1
1422,"SRM Valliammai Engineering College (Autonomous),S.R.M. Nagar, Kattankulathur, Chengalpattu,Kancheepuram, Chennai-603203.",MD,MEDICAL ELECTRONICSENGINEERING,41,55,14
1422,"SRM Valliammai Engineering College (Autonomous),S.R.M. Nagar, Kattankulathur, Chengalpattu,Kancheepuram, Chennai-603203.",ME,MECHANICAL ENGINEERING,41,41,0
1423,"Asan Memorial College of Engineering andTechnology, Asan Nagar, 9th kilometer, ChengalpattuMahabalipuram Highway, Post Box No.6,Chengalpattu-603001.",AD,Artificial Intelligence and DataScience,26,40,14
1423,"Asan Memorial College of Engineering andTechnology, Asan Nagar, 9th kilometer, ChengalpattuMahabalipuram Highway, Post Box No.6,Chengalpattu-603001.",CS,COMPUTER SCIENCE ANDENGINEERING,27,41,14
1423,"Asan Memorial College of Engineering andTechnology, Asan Nagar, 9th kilometer, ChengalpattuMahabalipuram Highway, Post Box No.6,Chengalpattu-603001.",EC,ELECTRONICS ANDCOMMUNICATIONENGINEERING,14,27,13
1423,"Asan Memorial College of Engineering andTechnology, Asan Nagar, 9th kilometer, ChengalpattuMahabalipuram Highway, Post Box No.6,Chengalpattu-603001.",EE,ELECTRICAL AND ELECTRONICSENGINEERING,0,14,14
1423,"Asan Memorial College of Engineering andTechnology, Asan Nagar, 9th kilometer, ChengalpattuMahabalipuram Highway, Post Box No.6,Chengalpattu-603001.",IT,INFORMATION TECHNOLOGY,26,41,15
1423,"Asan Memorial College of Engineering andTechnology, Asan Nagar, 9th kilometer, ChengalpattuMahabalipuram Highway, Post Box No.6,Chengalpattu-603001.",ME,MECHANICAL ENGINEERING,14,14,0
1423,Asan Memorial College of Engineering and TechnologyChengalpattu-603 001.,RM,ROBOTICS AND AUTOMATION,14,0,-14
1423,"Asan Memorial College of Engineering andTechnology, Asan Nagar, 9th kilometer, ChengalpattuMahabalipuram Highway, Post Box No.6,Chengalpattu-603001.",SC,Computer Science andEngineering (Cyber Security),0,40,40
1424,"Dhaanish Ahmed College of Engineering, DhaanishNagar, Vanchuvancherry, Padappai(Near Tambaram),Sriperumbudur Taluk, Kancheepuram District-601301.",AD,Artificial Intelligence and DataScience,64,45,-19
1424,"Dhaanish Ahmed College of Engineering, DhaanishNagar, Vanchuvancherry, Padappai(Near Tambaram),Sriperumbudur Taluk, Kancheepuram District-601301.",CB,COMPUTER SCIENCE ANDBUSSINESS SYSTEM,28,18,-10
1424,"Dhaanish Ahmed College of Engineering, DhaanishNagar, Vanchuvancherry, Padappai(Near Tambaram),Sriperumbudur Taluk, Kancheepuram District-601301.",CS,COMPUTER SCIENCE ANDENGINEERING,71,64,-7
1424,"Dhaanish Ahmed College of Engineering, DhaanishNagar, Vanchuvancherry, Padappai(Near Tambaram),Sriperumbudur Taluk, Kancheepuram District-601301.",EC,ELECTRONICS ANDCOMMUNICATIONENGINEERING,45,46,1
1424,"Dhaanish Ahmed College of Engineering, DhaanishNagar, Vanchuvancherry, Padappai(Near Tambaram),Sriperumbudur Taluk, Kancheepuram District-601301.",EE,ELECTRICAL AND ELECTRONICSENGINEERING,27,22,-5
1424,"Dhaanish Ahmed College of Engineering, DhaanishNagar, Vanchuvancherry, Padappai(Near Tambaram),Sriperumbudur Taluk, Kancheepuram District-601301.",ME,MECHANICAL ENGINEERING,27,13,-14
1424,"Dhaanish Ahmed College of Engineering, DhaanishNagar, Vanchuvancherry, Padappai(Near Tambaram),Sriperumbudur Taluk, Kancheepuram District-601301.",PE,PETROLEUM ENGINEERING,27,23,-4
1424,"Dhaanish Ahmed College of Engineering, DhaanishNagar, Vanchuvancherry, Padappai(Near Tambaram),Sriperumbudur Taluk, Kancheepuram District-601301.",RM,ROBOTICS AND AUTOMATION,27,22,-5
1426,"Sri Ramanujar Engineering College, Vandalur,Kolapakkam, Kanchipuram, Chennai-600127.",AD,Artificial Intelligence and DataScience,35,35,0
1426,"Sri Ramanujar Engineering College, Vandalur,Kolapakkam, Kanchipuram, Chennai-600127.",CB,COMPUTER SCIENCE ANDBUSSINESS SYSTEM,0,35,35
1426,"Sri Ramanujar Engineering College, Vandalur,Kolapakkam, Kanchipuram, Chennai-600127.",CS,COMPUTER SCIENCE ANDENGINEERING,52,53,1
1426,"Sri Ramanujar Engineering College, Vandalur,Kolapakkam, Kanchipuram, Chennai-600127.",EC,ELECTRONICS ANDCOMMUNICATIONENGINEERING,35,35,0
1426,"Sri Ramanujar Engineering College, Vandalur,Kolapakkam, Kanchipuram, Chennai-600127.",EE,ELECTRICAL AND ELECTRONICSENGINEERING,19,19,0
1426,"Sri Ramanujar Engineering College, Vandalur,Kolapakkam, Kanchipuram, Chennai-600127.",IT,INFORMATION TECHNOLOGY,35,70,35
1426,"Sri Ramanujar Engineering College, Vandalur,Kolapakkam, Kanchipuram, Chennai-600127.",ME,MECHANICAL ENGINEERING,35,36,1
1427,"Sri Krishna Engineering College, Panapakkam NearPadappai Via Tambaram, Kanchipuram, Chennai-601301.",AD,Artificial Intelligence and DataScience,55,55,0
1427,"Sri Krishna Engineering College, Panapakkam NearPadappai Via Tambaram, Kanchipuram, Chennai-601301.",CS,COMPUTER SCIENCE ANDENGINEERING,54,54,0
1427,"Sri Krishna Engineering College, Panapakkam NearPadappai Via Tambaram, Kanchipuram, Chennai-601301.",EC,ELECTRONICS ANDCOMMUNICATIONENGINEERING,55,54,-1
1427,"Sri Krishna Engineering College, Panapakkam NearPadappai Via Tambaram, Kanchipuram, Chennai-601301.",EE,ELECTRICAL AND ELECTRONICSENGINEERING,27,28,1
1427,"Sri Krishna Engineering College, Panapakkam NearPadappai Via Tambaram, Kanchipuram, Chennai-601301.",FT,FASHION TECHNOLOGY,27,26,-1
1427,"Sri Krishna Engineering College, Panapakkam NearPadappai Via Tambaram, Kanchipuram, Chennai-601301.",IT,INFORMATION TECHNOLOGY,26,28,2
1428,"E.S.College of Engineering and Technology, ChennaiTrunk Road, Ayyankoilpattu, Villupuram-605602.",AD,Artificial Intelligence and DataScience,50,50,0
1428,"E.S.College of Engineering and Technology, ChennaiTrunk Road, Ayyankoilpattu, Villupuram-605602.",CS,COMPUTER SCIENCE ANDENGINEERING,49,50,1
1428,"E.S.College of Engineering and Technology, ChennaiTrunk Road, Ayyankoilpattu, Villupuram-605602.",EC,ELECTRONICS ANDCOMMUNICATIONENGINEERING,54,53,-1
1428,"E.S.College of Engineering and Technology, ChennaiTrunk Road, Ayyankoilpattu, Villupuram-605602.",IT,INFORMATION TECHNOLOGY,54,50,-4
1430,"Maha Barathi Engineering College, A. Vasudevanur(post), Chinnasalem, Kallakurichi (Taluk), Villupuram-606201.",AD,Artificial Intelligence and DataScience,0,54,54
1430,"Maha Barathi Engineering College, A. Vasudevanur(post), Chinnasalem, Kallakurichi (Taluk), Villupuram-606201.",CE,CIVIL  ENGINEERING,18,28,10
1430,"Maha Barathi Engineering College, A. Vasudevanur(post), Chinnasalem, Kallakurichi (Taluk), Villupuram-606201.",CS,COMPUTER SCIENCE ANDENGINEERING,54,135,81
1430,"Maha Barathi Engineering College, A. Vasudevanur(post), Chinnasalem, Kallakurichi (Taluk), Villupuram-606201.",EC,ELECTRONICS ANDCOMMUNICATIONENGINEERING,34,55,21
1430,"Maha Barathi Engineering College, A. Vasudevanur(post), Chinnasalem, Kallakurichi (Taluk), Villupuram-606201.",EE,ELECTRICAL AND ELECTRONICSENGINEERING,44,55,11
1430,"Maha Barathi Engineering College, A. Vasudevanur(post), Chinnasalem, Kallakurichi (Taluk), Villupuram-606201.",ME,MECHANICAL ENGINEERING,44,54,10
1431,"New Prince Shri Bhavani College of Engineering andTechnology (Autonomous), Vengaivasal Main Road,Gowrivakkam, Chennai-600073.",AD,Artificial Intelligence and DataScience,40,71,31
1431,"New Prince Shri Bhavani College of Engineering andTechnology (Autonomous), Vengaivasal Main Road,Gowrivakkam, Chennai-600073.",CE,CIVIL  ENGINEERING,18,28,10
1431,"New Prince Shri Bhavani College of Engineering andTechnology (Autonomous), Vengaivasal Main Road,Gowrivakkam, Chennai-600073.",CS,COMPUTER SCIENCE ANDENGINEERING,64,136,72
1431,"New Prince Shri Bhavani College of Engineering andTechnology (Autonomous), Vengaivasal Main Road,Gowrivakkam, Chennai-600073.",EC,ELECTRONICS ANDCOMMUNICATIONENGINEERING,35,50,15
1431,"New Prince Shri Bhavani College of Engineering andTechnology (Autonomous), Vengaivasal Main Road,Gowrivakkam, Chennai-600073.",EE,ELECTRICAL AND ELECTRONICSENGINEERING,18,27,9
1431,"New Prince Shri Bhavani College of Engineering andTechnology (Autonomous), Vengaivasal Main Road,Gowrivakkam, Chennai-600073.",IT,INFORMATION TECHNOLOGY,35,91,56
1431,"New Prince Shri Bhavani College of Engineering andTechnology (Autonomous), Vengaivasal Main Road,Gowrivakkam, Chennai-600073.",ME,MECHANICAL ENGINEERING,19,26,7
1431,"New Prince Shri Bhavani College of Engineering andTechnology (Autonomous), Vengaivasal Main Road,Gowrivakkam, Chennai-600073.",SC,Computer Science andEngineering (Cyber Security),43,99,56
1432,"Rajalakshmi Institute of Technology (Autonomous),Bangalore Highway Road, Kuthambakkam, Chennai-600124.",AD,Artificial Intelligence and DataScience,81,191,110
1432,"Rajalakshmi Institute of Technology (Autonomous),Bangalore Highway Road, Kuthambakkam, Chennai-600124.",AM,COMPUTER SCIENCE ANDENGINEERING (AI ANDMACHINE LEARNING),27,81,54
1432,"Rajalakshmi Institute of Technology (Autonomous),Bangalore Highway Road, Kuthambakkam, Chennai-600124.",BT,BIO TECHNOLOGY,0,28,28
1432,"Rajalakshmi Institute of Technology (Autonomous),Bangalore Highway Road, Kuthambakkam, Chennai-600124.",CB,COMPUTER SCIENCE ANDBUSSINESS SYSTEM,55,81,26
1432,"Rajalakshmi Institute of Technology (Autonomous),Bangalore Highway Road, Kuthambakkam, Chennai-600124.",CO,COMPUTER ANDCOMMUNICATIONENGINEERING,28,55,27
1432,"Rajalakshmi Institute of Technology (Autonomous),Bangalore Highway Road, Kuthambakkam, Chennai-600124.",CS,COMPUTER SCIENCE ANDENGINEERING,107,217,110
1432,"Rajalakshmi Institute of Technology (Autonomous),Bangalore Highway Road, Kuthambakkam, Chennai-600124.",EC,ELECTRONICS ANDCOMMUNICATIONENGINEERING,54,81,27
1432,"Rajalakshmi Institute of Technology (Autonomous),Bangalore Highway Road, Kuthambakkam, Chennai-600124.",EV,Electronics Engineering (VLSIDesign and Technology),0,81,81
1432,"Rajalakshmi Institute of Technology (Autonomous),Bangalore Highway Road, Kuthambakkam, Chennai-600124.",ME,MECHANICAL ENGINEERING,27,55,28
1434,"Surya Group of Institutions, NH-45, GST Road,Vikiravandi, Villupuram-605652.",AD,Artificial Intelligence and DataScience,40,39,-1
1434,"Surya Group of Institutions, NH-45, GST Road,Vikiravandi, Villupuram-605652.",AE,AERONAUTICAL ENGINEERING,45,25,-20
1434,"Surya Group of Institutions, NH-45, GST Road,Vikiravandi, Villupuram-605652.",AG,AGRICULTURE ENGINEERING,21,22,1
1434,"Surya Group of Institutions, NH-45, GST Road,Vikiravandi, Villupuram-605652.",AU,AUTOMOBILE ENGINEERING,22,25,3
1434,"Surya Group of Institutions, NH-45, GST Road,Vikiravandi, Villupuram-605652.",CE,CIVIL  ENGINEERING,23,24,1
1434,"Surya Group of Institutions, NH-45, GST Road,Vikiravandi, Villupuram-605652.",CS,COMPUTER SCIENCE ANDENGINEERING,41,36,-5
1434,"Surya Group of Institutions, NH-45, GST Road,Vikiravandi, Villupuram-605652.",EC,ELECTRONICS ANDCOMMUNICATIONENGINEERING,46,49,3
1434,"Surya Group of Institutions, NH-45, GST Road,Vikiravandi, Villupuram-605652.",EE,ELECTRICAL AND ELECTRONICSENGINEERING,45,49,4
1434,"Surya Group of Institutions, NH-45, GST Road,Vikiravandi, Villupuram-605652.",ME,MECHANICAL ENGINEERING,45,49,4
1434,"Surya Group of Institutions, NH-45, GST Road,Vikiravandi, Villupuram-605652.",SC,Computer Science andEngineering (Cyber Security),22,25,3
1436,"A.R.Engineering College, Vadakuchipalayam,Kappiyampuliyur post, Villupuram-605601.",AD,Artificial Intelligence and DataScience,54,45,-9
1436,"A.R.Engineering College, Vadakuchipalayam,Kappiyampuliyur post, Villupuram-605601.",CE,CIVIL  ENGINEERING,27,28,1
1436,"A.R.Engineering College, Vadakuchipalayam,Kappiyampuliyur post, Villupuram-605601.",CS,COMPUTER SCIENCE ANDENGINEERING,54,45,-9
1436,"A.R.Engineering College, Vadakuchipalayam,Kappiyampuliyur post, Villupuram-605601.",EC,ELECTRONICS ANDCOMMUNICATIONENGINEERING,54,54,0
1436,"A.R.Engineering College, Vadakuchipalayam,Kappiyampuliyur post, Villupuram-605601.",EE,ELECTRICAL AND ELECTRONICSENGINEERING,27,27,0
1436,"A.R.Engineering College, Vadakuchipalayam,Kappiyampuliyur post, Villupuram-605601.",ME,MECHANICAL ENGINEERING,55,54,-1
1437,"Rrase College of Engineering, Vanjuvancherry,Padappai, Sriperumbadur, Kancheepuram -601301.",AD,Artificial Intelligence and DataScience,18,18,0
1437,"Rrase College of Engineering, Vanjuvancherry,Padappai, Sriperumbadur, Kancheepuram -601301.",AU,AUTOMOBILE ENGINEERING,22,18,-4
1437,"Rrase College of Engineering, Vanjuvancherry,Padappai, Sriperumbadur, Kancheepuram -601301.",CE,CIVIL  ENGINEERING,23,17,-6
1437,"Rrase College of Engineering, Vanjuvancherry,Padappai, Sriperumbadur, Kancheepuram -601301.",CS,COMPUTER SCIENCE ANDENGINEERING,35,35,0
1437,"Rrase College of Engineering, Vanjuvancherry,Padappai, Sriperumbadur, Kancheepuram -601301.",EC,ELECTRONICS ANDCOMMUNICATIONENGINEERING,45,35,-10
1437,"Rrase College of Engineering, Vanjuvancherry,Padappai, Sriperumbadur, Kancheepuram -601301.",EE,ELECTRICAL AND ELECTRONICSENGINEERING,22,18,-4
1437,"Rrase College of Engineering, Vanjuvancherry,Padappai, Sriperumbadur, Kancheepuram -601301.",IT,INFORMATION TECHNOLOGY,35,35,0
1437,"Rrase College of Engineering, Vanjuvancherry,Padappai, Sriperumbadur, Kancheepuram -601301.",ME,MECHANICAL ENGINEERING,23,18,-5
1437,"Rrase College of Engineering, Vanjuvancherry,Padappai, Sriperumbadur, Kancheepuram -601301.",SC,Computer Science andEngineering (Cyber Security),19,18,-1
1438,"Sree Krishna College of Engineering, Anaicut Post,Unnai Village, Vellore-632101.",CE,CIVIL  ENGINEERING,23,23,0
1438,"Sree Krishna College of Engineering, Anaicut Post,Unnai Village, Vellore-632101.",CS,COMPUTER SCIENCE ANDENGINEERING,36,36,0
1438,"Sree Krishna College of Engineering, Anaicut Post,Unnai Village, Vellore-632101.",EC,ELECTRONICS ANDCOMMUNICATIONENGINEERING,35,35,0
1438,"Sree Krishna College of Engineering, Anaicut Post,Unnai Village, Vellore-632101.",EE,ELECTRICAL AND ELECTRONICSENGINEERING,23,23,0
1438,"Sree Krishna College of Engineering, Anaicut Post,Unnai Village, Vellore-632101.",ME,MECHANICAL ENGINEERING,50,49,-1
1441,"A.K.T.Memorial College of Engineering andTechnology, Neelamangalam( Post ), KallakurichiTaluk, Villupuram District-606202.",AD,Artificial Intelligence and DataScience,19,36,17
1441,"A.K.T.Memorial College of Engineering andTechnology, Neelamangalam( Post ), KallakurichiTaluk, Villupuram District-606202.",CE,CIVIL  ENGINEERING,22,23,1
1441,"A.K.T.Memorial College of Engineering andTechnology, Neelamangalam( Post ), KallakurichiTaluk, Villupuram District-606202.",CS,COMPUTER SCIENCE ANDENGINEERING,34,53,19
1441,"A.K.T.Memorial College of Engineering andTechnology, Neelamangalam( Post ), KallakurichiTaluk, Villupuram District-606202.",EC,ELECTRONICS ANDCOMMUNICATIONENGINEERING,35,35,0
1441,"A.K.T.Memorial College of Engineering andTechnology, Neelamangalam( Post ), KallakurichiTaluk, Villupuram District-606202.",EE,ELECTRICAL AND ELECTRONICSENGINEERING,44,53,9
1441,"A.K.T.Memorial College of Engineering andTechnology, Neelamangalam( Post ), KallakurichiTaluk, Villupuram District-606202.",IT,INFORMATION TECHNOLOGY,35,36,1
1441,"A.K.T.Memorial College of Engineering andTechnology, Neelamangalam( Post ), KallakurichiTaluk, Villupuram District-606202.",ME,MECHANICAL ENGINEERING,45,46,1
1442,"Prince Dr. K. Vasudevan College of Engineering andTechnology, Medavakkam-Mambakkam Road,Ponmar, Chennai-600127.",AD,Artificial Intelligence and DataScience,35,35,0
1442,"Prince Dr. K. Vasudevan College of Engineering andTechnology, Medavakkam-Mambakkam Road,Ponmar, Chennai-600127.",BM,BIO MEDICAL ENGINEERING,18,19,1
1442,"Prince Dr. K. Vasudevan College of Engineering andTechnology, Medavakkam-Mambakkam Road,Ponmar, Chennai-600127.",CS,COMPUTER SCIENCE ANDENGINEERING,34,35,1
1442,"Prince Dr. K. Vasudevan College of Engineering andTechnology, Medavakkam-Mambakkam Road,Ponmar, Chennai-600127.",SC,Computer Science andEngineering (Cyber Security),35,35,0
1444,"R.M.Engineering College (formerly Chendu College ofEngineering and Technology),  Zamin EndathurVillage, Madurantakam, Kanchipuram-603311.",AD,Artificial Intelligence and DataScience,0,41,41
1444,"R.M.Engineering College (formerly Chendu College ofEngineering and Technology),  Zamin EndathurVillage, Madurantakam, Kanchipuram-603311.",CE,CIVIL  ENGINEERING,18,19,1
1444,"R.M.Engineering College (formerly Chendu College ofEngineering and Technology),  Zamin EndathurVillage, Madurantakam, Kanchipuram-603311.",CS,COMPUTER SCIENCE ANDENGINEERING,45,36,-9
1444,"R.M.Engineering College (formerly Chendu College ofEngineering and Technology),  Zamin EndathurVillage, Madurantakam, Kanchipuram-603311.",EC,ELECTRONICS ANDCOMMUNICATIONENGINEERING,45,40,-5
1444,"R.M.Engineering College (formerly Chendu College ofEngineering and Technology),  Zamin EndathurVillage, Madurantakam, Kanchipuram-603311.",ME,MECHANICAL ENGINEERING,35,40,5
1444,"R.M.Engineering College (formerly Chendu College ofEngineering and Technology),  Zamin EndathurVillage, Madurantakam, Kanchipuram-603311.",SC,Computer Science andEngineering (Cyber Security),0,17,17
1445,"Sri Rangapoopathi College of Engineering,Alampoondi Village & Post, Gingee Taluk, VillupuramDistrict-604151.",AD,Artificial Intelligence and DataScience,0,53,53
1445,"Sri Rangapoopathi College of Engineering,Alampoondi Village & Post, Gingee Taluk, VillupuramDistrict-604151.",CE,CIVIL  ENGINEERING,49,28,-21
1445,"Sri Rangapoopathi College of Engineering,Alampoondi Village & Post, Gingee Taluk, VillupuramDistrict-604151.",CS,COMPUTER SCIENCE ANDENGINEERING,54,82,28
1445,"Sri Rangapoopathi College of Engineering,Alampoondi Village & Post, Gingee Taluk, VillupuramDistrict-604151.",EC,ELECTRONICS ANDCOMMUNICATIONENGINEERING,18,28,10
1445,"Sri Rangapoopathi College of Engineering,Alampoondi Village & Post, Gingee Taluk, VillupuramDistrict-604151.",EE,ELECTRICAL AND ELECTRONICSENGINEERING,44,54,10
1445,"Sri Rangapoopathi College of Engineering,Alampoondi Village & Post, Gingee Taluk, VillupuramDistrict-604151.",ME,MECHANICAL ENGINEERING,89,54,-35
1445,"Sri Rangapoopathi College of Engineering,Alampoondi Village & Post, Gingee Taluk, VillupuramDistrict-604151.",SC,Computer Science andEngineering (Cyber Security),0,54,54
1449,"Saraswathy College of Engineering and Technology,NH-45 Main Road, Olakkur, Tindivanam, Villupuram-604307.",AD,Artificial Intelligence and DataScience,0,54,54
1449,"Saraswathy College of Engineering and Technology,NH-45 Main Road, Olakkur, Tindivanam, Villupuram-604307.",AG,AGRICULTURE ENGINEERING,55,54,-1
1449,"Saraswathy College of Engineering and Technology,NH-45 Main Road, Olakkur, Tindivanam, Villupuram-604307.",CE,CIVIL  ENGINEERING,27,28,1
1449,"Saraswathy College of Engineering and Technology,NH-45 Main Road, Olakkur, Tindivanam, Villupuram-604307.",CS,COMPUTER SCIENCE ANDENGINEERING,54,54,0
1449,"Saraswathy College of Engineering and Technology,NH-45 Main Road, Olakkur, Tindivanam, Villupuram-604307.",EC,ELECTRONICS ANDCOMMUNICATIONENGINEERING,54,54,0
1449,"Saraswathy College of Engineering and Technology,NH-45 Main Road, Olakkur, Tindivanam, Villupuram-604307.",ME,MECHANICAL ENGINEERING,54,28,-26
1450,"Loyola-ICAM College of Engineering and Technology,Loyola College Campus, Chennai-600034.",AD,Artificial Intelligence and DataScience,0,27,27
1450,"Loyola-ICAM College of Engineering and Technology,Loyola College Campus, Chennai-600034.",CS,COMPUTER SCIENCE ANDENGINEERING,52,55,3
1450,"Loyola-ICAM College of Engineering and Technology,Loyola College Campus, Chennai-600034.",EC,ELECTRONICS ANDCOMMUNICATIONENGINEERING,27,27,0
1450,"Loyola-ICAM College of Engineering and Technology,Loyola College Campus, Chennai-600034.",EE,ELECTRICAL AND ELECTRONICSENGINEERING,27,28,1
1450,"Loyola-ICAM College of Engineering and Technology,Loyola College Campus, Chennai-600034.",IT,INFORMATION TECHNOLOGY,27,27,0
1450,"Loyola-ICAM College of Engineering and Technology,Loyola College Campus, Chennai-600034.",ME,MECHANICAL ENGINEERING,27,27,0
1452,"PERI Institute of Technology (Autonomous),Mannivakkam,Tambaram, Kancheepuram, Chennai-600048.",AD,Artificial Intelligence and DataScience,18,35,17
1452,PERI Institute of Technology  Mannivakkam  WestTambaram  Chennai 600048,AG,AGRICULTURAL ENGINEERING,18,0,-18
1452,"PERI Institute of Technology (Autonomous),Mannivakkam,Tambaram, Kancheepuram, Chennai-600048.",AM,COMPUTER SCIENCE ANDENGINEERING (AI ANDMACHINE LEARNING),0,18,18
1452,"PERI Institute of Technology (Autonomous),Mannivakkam,Tambaram, Kancheepuram, Chennai-600048.",CB,COMPUTER SCIENCE ANDBUSSINESS SYSTEM,35,35,0
1452,"PERI Institute of Technology (Autonomous),Mannivakkam,Tambaram, Kancheepuram, Chennai-600048.",CE,CIVIL  ENGINEERING,18,17,-1
1452,"PERI Institute of Technology (Autonomous),Mannivakkam,Tambaram, Kancheepuram, Chennai-600048.",CS,COMPUTER SCIENCE ANDENGINEERING,106,105,-1
1452,"PERI Institute of Technology (Autonomous),Mannivakkam,Tambaram, Kancheepuram, Chennai-600048.",EC,ELECTRONICS ANDCOMMUNICATIONENGINEERING,35,36,1
1452,"PERI Institute of Technology (Autonomous),Mannivakkam,Tambaram, Kancheepuram, Chennai-600048.",EE,ELECTRICAL AND ELECTRONICSENGINEERING,17,19,2
1452,"PERI Institute of Technology (Autonomous),Mannivakkam,Tambaram, Kancheepuram, Chennai-600048.",IT,INFORMATION TECHNOLOGY,34,35,1
1452,"PERI Institute of Technology (Autonomous),Mannivakkam,Tambaram, Kancheepuram, Chennai-600048.",ME,MECHANICAL ENGINEERING,18,19,1
1452,"PERI Institute of Technology (Autonomous),Mannivakkam,Tambaram, Kancheepuram, Chennai-600048.",SC,Computer Science andEngineering (Cyber Security),0,39,39
1501,"Adhiparasakthi College of Engineering, G.B.Nagar,Kalavai, Arcot Taluk, Vellore District-632506.",AD,Artificial Intelligence and DataScience,0,35,35
1501,"Adhiparasakthi College of Engineering, G.B.Nagar,Kalavai, Arcot Taluk, Vellore District-632506.",CE,CIVIL  ENGINEERING,27,26,-1
1501,"Adhiparasakthi College of Engineering, G.B.Nagar,Kalavai, Arcot Taluk, Vellore District-632506.",CS,COMPUTER SCIENCE ANDENGINEERING,35,36,1
1501,"Adhiparasakthi College of Engineering, G.B.Nagar,Kalavai, Arcot Taluk, Vellore District-632506.",EC,ELECTRONICS ANDCOMMUNICATIONENGINEERING,44,36,-8
1501,"Adhiparasakthi College of Engineering, G.B.Nagar,Kalavai, Arcot Taluk, Vellore District-632506.",EE,ELECTRICAL AND ELECTRONICSENGINEERING,26,17,-9
1501,"Adhiparasakthi College of Engineering, G.B.Nagar,Kalavai, Arcot Taluk, Vellore District-632506.",IT,INFORMATION TECHNOLOGY,33,35,2
1501,"Adhiparasakthi College of Engineering, G.B.Nagar,Kalavai, Arcot Taluk, Vellore District-632506.",ME,MECHANICAL ENGINEERING,25,18,-7
1501,"Adhiparasakthi College of Engineering, G.B.Nagar,Kalavai, Arcot Taluk, Vellore District-632506.",SC,Computer Science andEngineering (Cyber Security),0,18,18
1503,"Arulmigu Meenakshi Amman College of Engineering,Vadamavandal Village, Namandi Post,(NearKanchipuram),Tiruvanamalai-604410.",BT,BIO TECHNOLOGY,17,14,-3
1503,"Arulmigu Meenakshi Amman College of Engineering,Vadamavandal Village, Namandi Post,(NearKanchipuram),Tiruvanamalai-604410.",CE,CIVIL  ENGINEERING,18,22,4
1503,"Arulmigu Meenakshi Amman College of Engineering,Vadamavandal Village, Namandi Post,(NearKanchipuram),Tiruvanamalai-604410.",CH,CHEMICAL  ENGINEERING,21,19,-2
1503,"Arulmigu Meenakshi Amman College of Engineering,Vadamavandal Village, Namandi Post,(NearKanchipuram),Tiruvanamalai-604410.",CS,COMPUTER SCIENCE ANDENGINEERING,32,30,-2
1503,"Arulmigu Meenakshi Amman College of Engineering,Vadamavandal Village, Namandi Post,(NearKanchipuram),Tiruvanamalai-604410.",EC,ELECTRONICS ANDCOMMUNICATIONENGINEERING,46,40,-6
1503,"Arulmigu Meenakshi Amman College of Engineering,Vadamavandal Village, Namandi Post,(NearKanchipuram),Tiruvanamalai-604410.",EE,ELECTRICAL AND ELECTRONICSENGINEERING,18,20,2
1503,"Arulmigu Meenakshi Amman College of Engineering,Vadamavandal Village, Namandi Post,(NearKanchipuram),Tiruvanamalai-604410.",IC,INSTRUMENTATION ANDCONTROL ENGINEERING,11,10,-1
1503,"Arulmigu Meenakshi Amman College of Engineering,Vadamavandal Village, Namandi Post,(NearKanchipuram),Tiruvanamalai-604410.",IT,INFORMATION TECHNOLOGY,11,10,-1
1503,"Arulmigu Meenakshi Amman College of Engineering,Vadamavandal Village, Namandi Post,(NearKanchipuram),Tiruvanamalai-604410.",ME,MECHANICAL ENGINEERING,65,63,-2
1504,"Arunai Engineering College, Chittor-Cuddalore Raod,Mathur, Tiruvannamalai-606603.",AD,Artificial Intelligence and DataScience,35,70,35
1504,"Arunai Engineering College, Chittor-Cuddalore Raod,Mathur, Tiruvannamalai-606603.",AG,AGRICULTURE ENGINEERING,35,36,1
1504,"Arunai Engineering College, Chittor-Cuddalore Raod,Mathur, Tiruvannamalai-606603.",AM,COMPUTER SCIENCE ANDENGINEERING (AI ANDMACHINE LEARNING),35,35,0
1504,"Arunai Engineering College, Chittor-Cuddalore Raod,Mathur, Tiruvannamalai-606603.",BT,BIO TECHNOLOGY,35,35,0
1504,"Arunai Engineering College, Chittor-Cuddalore Raod,Mathur, Tiruvannamalai-606603.",CE,CIVIL  ENGINEERING,18,19,1
1504,"Arunai Engineering College, Chittor-Cuddalore Raod,Mathur, Tiruvannamalai-606603.",CH,CHEMICAL  ENGINEERING,19,18,-1
1504,"Arunai Engineering College, Chittor-Cuddalore Raod,Mathur, Tiruvannamalai-606603.",CS,COMPUTER SCIENCE ANDENGINEERING,71,141,70
1504,"Arunai Engineering College, Chittor-Cuddalore Raod,Mathur, Tiruvannamalai-606603.",EC,ELECTRONICS ANDCOMMUNICATIONENGINEERING,71,70,-1
1504,"Arunai Engineering College, Chittor-Cuddalore Raod,Mathur, Tiruvannamalai-606603.",EE,ELECTRICAL AND ELECTRONICSENGINEERING,35,36,1
1504,"Arunai Engineering College, Chittor-Cuddalore Raod,Mathur, Tiruvannamalai-606603.",IT,INFORMATION TECHNOLOGY,35,70,35
1504,"Arunai Engineering College, Chittor-Cuddalore Raod,Mathur, Tiruvannamalai-606603.",ME,MECHANICAL ENGINEERING,35,36,1
1504,"Arunai Engineering College, Chittor-Cuddalore Raod,Mathur, Tiruvannamalai-606603.",SC,Computer Science andEngineering (Cyber Security),35,35,0
1505,"C.Abdul Hakeem College of Engineering andTechnology, Hakeem Nagar, Melvisharam, Vellore -632509.",AD,Artificial Intelligence and DataScience,27,27,0
1505,"C.Abdul Hakeem College of Engineering andTechnology, Hakeem Nagar, Melvisharam, Vellore -632509.",CE,CIVIL  ENGINEERING,14,14,0
1505,"C.Abdul Hakeem College of Engineering andTechnology, Hakeem Nagar, Melvisharam, Vellore -632509.",CS,COMPUTER SCIENCE ANDENGINEERING,55,55,0
1505,"C.Abdul Hakeem College of Engineering andTechnology, Hakeem Nagar, Melvisharam, Vellore -632509.",EC,ELECTRONICS ANDCOMMUNICATIONENGINEERING,26,26,0
1505,"C.Abdul Hakeem College of Engineering andTechnology, Hakeem Nagar, Melvisharam, Vellore -632509.",EE,ELECTRICAL AND ELECTRONICSENGINEERING,13,14,1
1505,"C.Abdul Hakeem College of Engineering andTechnology, Hakeem Nagar, Melvisharam, Vellore -632509.",IT,INFORMATION TECHNOLOGY,40,40,0
1505,"C.Abdul Hakeem College of Engineering andTechnology, Hakeem Nagar, Melvisharam, Vellore -632509.",ME,MECHANICAL ENGINEERING,26,27,1
1507,"Ganadipathy Tulsi's Jain Engineering College, Chittoor-Cuddalore Road, Kaniyambadi, Vellore-632102.",AD,Artificial Intelligence and DataScience,35,36,1
1507,"Ganadipathy Tulsi's Jain Engineering College, Chittoor-Cuddalore Road, Kaniyambadi, Vellore-632102.",CB,COMPUTER SCIENCE ANDBUSSINESS SYSTEM,18,16,-2
1507,"Ganadipathy Tulsi's Jain Engineering College, Chittoor-Cuddalore Road, Kaniyambadi, Vellore-632102.",CS,COMPUTER SCIENCE ANDENGINEERING,35,37,2
1507,"Ganadipathy Tulsi's Jain Engineering College, Chittoor-Cuddalore Road, Kaniyambadi, Vellore-632102.",EC,ELECTRONICS ANDCOMMUNICATIONENGINEERING,21,28,7
1507,"Ganadipathy Tulsi's Jain Engineering College, Chittoor-Cuddalore Road, Kaniyambadi, Vellore-632102.",EE,ELECTRICAL AND ELECTRONICSENGINEERING,26,28,2
1507,"Ganadipathy Tulsi's Jain Engineering College, Chittoor-Cuddalore Road, Kaniyambadi, Vellore-632102.",IT,INFORMATION TECHNOLOGY,35,51,16
1507,"Ganadipathy Tulsi's Jain Engineering College, Chittoor-Cuddalore Road, Kaniyambadi, Vellore-632102.",ME,MECHANICAL ENGINEERING,25,27,2
1507,"Ganadipathy Tulsi's Jain Engineering College, Chittoor-Cuddalore Road, Kaniyambadi, Vellore-632102.",SC,Computer Science andEngineering (Cyber Security),0,21,21
1509,"Meenakshi College of Engineering, 12,VembuliAmman Koil Street, West K K Nagar, Chennai-600078.",AD,Artificial Intelligence and DataScience,27,27,0
1509,"Meenakshi College of Engineering, 12,VembuliAmman Koil Street, West K K Nagar, Chennai-600078.",AM,COMPUTER SCIENCE ANDENGINEERING (AI ANDMACHINE LEARNING),27,27,0
1509,"Meenakshi College of Engineering, 12,VembuliAmman Koil Street, West K K Nagar, Chennai-600078.",CE,CIVIL  ENGINEERING,45,45,0
1509,"Meenakshi College of Engineering, 12,VembuliAmman Koil Street, West K K Nagar, Chennai-600078.",CS,COMPUTER SCIENCE ANDENGINEERING,54,55,1
1509,"Meenakshi College of Engineering, 12,VembuliAmman Koil Street, West K K Nagar, Chennai-600078.",EC,ELECTRONICS ANDCOMMUNICATIONENGINEERING,77,81,4
1509,"Meenakshi College of Engineering, 12,VembuliAmman Koil Street, West K K Nagar, Chennai-600078.",EE,ELECTRICAL AND ELECTRONICSENGINEERING,18,19,1
1509,"Meenakshi College of Engineering, 12,VembuliAmman Koil Street, West K K Nagar, Chennai-600078.",EI,ELECTRONICS ANDINSTRUMENTATIONENGINEERING,18,18,0
1509,"Meenakshi College of Engineering, 12,VembuliAmman Koil Street, West K K Nagar, Chennai-600078.",IT,INFORMATION TECHNOLOGY,55,55,0
1509,"Meenakshi College of Engineering, 12,VembuliAmman Koil Street, West K K Nagar, Chennai-600078.",ME,MECHANICAL ENGINEERING,45,45,0
1510,"Priyadarshini Engineering College, ChettiyappanurVillage & Post, Vaniyambadi, Vellore-635751.",AD,Artificial Intelligence and DataScience,0,36,36
1510,"Priyadarshini Engineering College, ChettiyappanurVillage & Post, Vaniyambadi, Vellore-635751.",CE,CIVIL  ENGINEERING,35,36,1
1510,"Priyadarshini Engineering College, ChettiyappanurVillage & Post, Vaniyambadi, Vellore-635751.",CS,COMPUTER SCIENCE ANDENGINEERING,54,52,-2
1510,"Priyadarshini Engineering College, ChettiyappanurVillage & Post, Vaniyambadi, Vellore-635751.",EC,ELECTRONICS ANDCOMMUNICATIONENGINEERING,36,35,-1
1510,"Priyadarshini Engineering College, ChettiyappanurVillage & Post, Vaniyambadi, Vellore-635751.",EE,ELECTRICAL AND ELECTRONICSENGINEERING,35,35,0
1510,"Priyadarshini Engineering College, ChettiyappanurVillage & Post, Vaniyambadi, Vellore-635751.",IT,INFORMATION TECHNOLOGY,34,35,1
1510,"Priyadarshini Engineering College, ChettiyappanurVillage & Post, Vaniyambadi, Vellore-635751.",ME,MECHANICAL ENGINEERING,35,36,1
1511,"RANIPPETTAI ENGINEERING COLLEGE,THENKADAPPANTHANGAL, VELLORE DISTRICT632513",CE,CIVIL  ENGINEERING,32,26,-6
1511,"RANIPPETTAI ENGINEERING COLLEGE,THENKADAPPANTHANGAL, VELLORE DISTRICT632514",CS,COMPUTER SCIENCE ANDENGINEERING,31,27,-4
1511,"RANIPPETTAI ENGINEERING COLLEGE,THENKADAPPANTHANGAL, VELLORE DISTRICT632517",EC,ELECTRONICS ANDCOMMUNICATIONENGINEERING,45,35,-10
1511,"RANIPPETTAI ENGINEERING COLLEGE,THENKADAPPANTHANGAL, VELLORE DISTRICT632516",EE,ELECTRICAL AND ELECTRONICSENGINEERING,44,35,-9
1511,"RANIPPETTAI ENGINEERING COLLEGE,THENKADAPPANTHANGAL, VELLORE DISTRICT632515",ME,MECHANICAL ENGINEERING,62,54,-8
1512,"S.K.P. Engineering College, Chinnkangiyanur,Somasipadi Post, Tiruvannamalai District-606611.",AD,Artificial Intelligence and DataScience,27,54,27
1512,"S.K.P. Engineering College, Chinnkangiyanur,Somasipadi Post, Tiruvannamalai District-606611.",AM,COMPUTER SCIENCE ANDENGINEERING (AI ANDMACHINE LEARNING),0,28,28
1512,"S.K.P. Engineering College, Chinnkangiyanur,Somasipadi Post, Tiruvannamalai District-606611.",CE,CIVIL  ENGINEERING,28,27,-1
1512,"S.K.P. Engineering College, Chinnkangiyanur,Somasipadi Post, Tiruvannamalai District-606611.",CS,COMPUTER SCIENCE ANDENGINEERING,55,55,0
1512,"S.K.P. Engineering College, Chinnkangiyanur,Somasipadi Post, Tiruvannamalai District-606611.",EC,ELECTRONICS ANDCOMMUNICATIONENGINEERING,27,27,0
1512,"S.K.P. Engineering College, Chinnkangiyanur,Somasipadi Post, Tiruvannamalai District-606611.",EE,ELECTRICAL AND ELECTRONICSENGINEERING,26,27,1
1512,"S.K.P. Engineering College, Chinnkangiyanur,Somasipadi Post, Tiruvannamalai District-606611.",IT,INFORMATION TECHNOLOGY,27,27,0
1512,"S.K.P. Engineering College, Chinnkangiyanur,Somasipadi Post, Tiruvannamalai District-606611.",ME,MECHANICAL ENGINEERING,27,27,0
1512,"S.K.P. Engineering College, Chinnkangiyanur,Somasipadi Post, Tiruvannamalai District-606611.",SC,Computer Science andEngineering (Cyber Security),27,27,0
1513,"Sri Balaji Chockalingam Engineering College,Irumbedu, Arni Taluk,Tiruvannamalai District-632317.",AD,Artificial Intelligence and DataScience,0,35,35
1513,"Sri Balaji Chockalingam Engineering College,Irumbedu, Arni Taluk,Tiruvannamalai District-632317.",CB,COMPUTER SCIENCE ANDBUSSINESS SYSTEM,0,45,45
1513,"Sri Balaji Chockalingam Engineering College,Irumbedu, Arni Taluk,Tiruvannamalai District-632317.",CS,COMPUTER SCIENCE ANDENGINEERING,35,35,0
1513,"Sri Balaji Chockalingam Engineering College,Irumbedu, Arni Taluk,Tiruvannamalai District-632317.",EC,ELECTRONICS ANDCOMMUNICATIONENGINEERING,45,45,0
1513,"Sri Balaji Chockalingam Engineering College,Irumbedu, Arni Taluk,Tiruvannamalai District-632317.",IT,INFORMATION TECHNOLOGY,34,37,3
1514,Sri Nandhanam College of Engineering and TechnologyMolagarampatti  Tirupattur  Vellore-635601,BT,BIO TECHNOLOGY,55,0,-55
1514,"Sri Nandhanam College of Engineering andTechnology, Molagarampatti, Tirupattur, Vellore-635601.",CS,COMPUTER SCIENCE ANDENGINEERING,54,54,0
1514,Sri Nandhanam College of Engineering and TechnologyMolagarampatti  Tirupattur  Vellore-635601,EE,ELECTRICAL ANDELECTRONICS ENGINEERING,38,0,-38
1514,Sri Nandhanam College of Engineering and TechnologyMolagarampatti  Tirupattur  Vellore-635601,ME,MECHANICAL ENGINEERING,54,0,-54
1514,Sri Nandhanam College of Engineering and TechnologyMolagarampatti  Tirupattur  Vellore-635601,MR,MARINE ENGINEERING,28,0,-28
1516,Thanthai Periyar Government Institute of TechnologyBagayam  Vellore District 632002,CE,CIVIL  ENGINEERING,55,55,0
1516,Thanthai Periyar Government Institute of TechnologyBagayam  Vellore District 632002,CS,COMPUTER SCIENCE ANDENGINEERING,53,55,2
1516,Thanthai Periyar Government Institute of TechnologyBagayam  Vellore District 632002,EC,ELECTRONICS ANDCOMMUNICATIONENGINEERING,107,108,1
1516,Thanthai Periyar Government Institute of TechnologyBagayam  Vellore District 632002,EE,ELECTRICAL AND ELECTRONICSENGINEERING,54,54,0
1516,Thanthai Periyar Government Institute of TechnologyBagayam  Vellore District 632002,ME,MECHANICAL ENGINEERING,108,109,1
1517,"Thirumalai Engineering College, Kilambi,Krishnapuram Post, Kanchipuram-631551.",AD,Artificial Intelligence and DataScience,19,26,7
1517,"Thirumalai Engineering College, Kilambi,Krishnapuram Post, Kanchipuram-631551.",AG,AGRICULTURE ENGINEERING,0,27,27
1517,"Thirumalai Engineering College, Kilambi,Krishnapuram Post, Kanchipuram-631551.",CE,CIVIL  ENGINEERING,23,27,4
1517,"Thirumalai Engineering College, Kilambi,Krishnapuram Post, Kanchipuram-631551.",CS,COMPUTER SCIENCE ANDENGINEERING,91,106,15
1517,"Thirumalai Engineering College, Kilambi,Krishnapuram Post, Kanchipuram-631551.",EC,ELECTRONICS ANDCOMMUNICATIONENGINEERING,23,27,4
1517,"Thirumalai Engineering College, Kilambi,Krishnapuram Post, Kanchipuram-631551.",EE,ELECTRICAL AND ELECTRONICSENGINEERING,23,27,4
1517,"Thirumalai Engineering College, Kilambi,Krishnapuram Post, Kanchipuram-631551.",IT,INFORMATION TECHNOLOGY,21,22,1
1517,"Thirumalai Engineering College, Kilambi,Krishnapuram Post, Kanchipuram-631551.",ME,MECHANICAL ENGINEERING,35,52,17
1518,"Thiruvalluvar College of Engineering and Technology,Arunachala City,Ponnur Hills, Vandavasi,Thiruvannamalai District-604505.",AE,AERONAUTICAL ENGINEERING,42,41,-1
1518,"Thiruvalluvar College of Engineering and Technology,Arunachala City,Ponnur Hills, Vandavasi,Thiruvannamalai District-604505.",AM,COMPUTER SCIENCE ANDENGINEERING (AI ANDMACHINE LEARNING),26,27,1
1518,"Thiruvalluvar College of Engineering and Technology,Arunachala City,Ponnur Hills, Vandavasi,Thiruvannamalai District-604505.",AU,AUTOMOBILE ENGINEERING,27,28,1
1518,"Thiruvalluvar College of Engineering and Technology,Arunachala City,Ponnur Hills, Vandavasi,Thiruvannamalai District-604505.",CE,CIVIL  ENGINEERING,62,61,-1
1518,"Thiruvalluvar College of Engineering and Technology,Arunachala City,Ponnur Hills, Vandavasi,Thiruvannamalai District-604505.",CS,COMPUTER SCIENCE ANDENGINEERING,81,82,1
1518,"Thiruvalluvar College of Engineering and Technology,Arunachala City,Ponnur Hills, Vandavasi,Thiruvannamalai District-604505.",EC,ELECTRONICS ANDCOMMUNICATIONENGINEERING,54,53,-1
1518,"Thiruvalluvar College of Engineering and Technology,Arunachala City,Ponnur Hills, Vandavasi,Thiruvannamalai District-604505.",EE,ELECTRICAL AND ELECTRONICSENGINEERING,41,41,0
1518,"Thiruvalluvar College of Engineering and Technology,Arunachala City,Ponnur Hills, Vandavasi,Thiruvannamalai District-604505.",EI,ELECTRONICS ANDINSTRUMENTATIONENGINEERING,27,28,1
1518,"Thiruvalluvar College of Engineering and Technology,Arunachala City,Ponnur Hills, Vandavasi,Thiruvannamalai District-604505.",IT,INFORMATION TECHNOLOGY,62,61,-1
1518,"Thiruvalluvar College of Engineering and Technology,Arunachala City,Ponnur Hills, Vandavasi,Thiruvannamalai District-604505.",ME,MECHANICAL ENGINEERING,81,81,0
1518,"Thiruvalluvar College of Engineering and Technology,Arunachala City,Ponnur Hills, Vandavasi,Thiruvannamalai District-604505.",PC,PETRO CHEMICALTECHNOLOGY,27,28,1
1519,"Bharathidasan Engineering College, K.BandarapalliPost, Nattrampalli, Vellore District-635854.",AD,Artificial Intelligence and DataScience,0,45,45
1519,"Bharathidasan Engineering College, K.BandarapalliPost, Nattrampalli, Vellore District-635854.",CE,CIVIL  ENGINEERING,23,24,1
1519,"Bharathidasan Engineering College, K.BandarapalliPost, Nattrampalli, Vellore District-635854.",CS,COMPUTER SCIENCE ANDENGINEERING,72,104,32
1519,"Bharathidasan Engineering College, K.BandarapalliPost, Nattrampalli, Vellore District-635854.",EC,ELECTRONICS ANDCOMMUNICATIONENGINEERING,49,50,1
1519,"Bharathidasan Engineering College, K.BandarapalliPost, Nattrampalli, Vellore District-635854.",EE,ELECTRICAL AND ELECTRONICSENGINEERING,50,49,-1
1519,"Bharathidasan Engineering College, K.BandarapalliPost, Nattrampalli, Vellore District-635854.",IT,INFORMATION TECHNOLOGY,45,46,1
1519,"Bharathidasan Engineering College, K.BandarapalliPost, Nattrampalli, Vellore District-635854.",ME,MECHANICAL ENGINEERING,50,49,-1
1520,"Kingston Engineering College, Chittoor Main Road,Chiristianpet Village, Mettukulam Panchayat, KatpadiTaluk, Vellore District-632059.",AD,Artificial Intelligence and DataScience,35,35,0
1520,"Kingston Engineering College, Chittoor Main Road,Chiristianpet Village, Mettukulam Panchayat, KatpadiTaluk, Vellore District-632059.",CB,COMPUTER SCIENCE ANDBUSSINESS SYSTEM,18,18,0
1520,"Kingston Engineering College, Chittoor Main Road,Chiristianpet Village, Mettukulam Panchayat, KatpadiTaluk, Vellore District-632059.",CS,COMPUTER SCIENCE ANDENGINEERING,69,70,1
1520,"Kingston Engineering College, Chittoor Main Road,Chiristianpet Village, Mettukulam Panchayat, KatpadiTaluk, Vellore District-632059.",EC,ELECTRONICS ANDCOMMUNICATIONENGINEERING,35,35,0
1520,"Kingston Engineering College, Chittoor Main Road,Chiristianpet Village, Mettukulam Panchayat, KatpadiTaluk, Vellore District-632059.",IT,INFORMATION TECHNOLOGY,35,36,1
1520,"Kingston Engineering College, Chittoor Main Road,Chiristianpet Village, Mettukulam Panchayat, KatpadiTaluk, Vellore District-632059.",ME,MECHANICAL ENGINEERING,19,18,-1
1523,"Global Institute of Engineering and Technology,257/1, Bangalore-Chennai Highway,Melvisharam,Vellore-632509.",AD,Artificial Intelligence and DataScience,18,35,17
1523,"Global Institute of Engineering and Technology,257/1, Bangalore-Chennai Highway,Melvisharam,Vellore-632509.",AM,COMPUTER SCIENCE ANDENGINEERING (AI ANDMACHINE LEARNING),0,18,18
1523,"Global Institute of Engineering and Technology,257/1, Bangalore-Chennai Highway,Melvisharam,Vellore-632509.",AU,AUTOMOBILE ENGINEERING,18,18,0
1523,"Global Institute of Engineering and Technology,257/1, Bangalore-Chennai Highway,Melvisharam,Vellore-632509.",CE,CIVIL  ENGINEERING,17,18,1
1523,"Global Institute of Engineering and Technology,257/1, Bangalore-Chennai Highway,Melvisharam,Vellore-632509.",CS,COMPUTER SCIENCE ANDENGINEERING,53,52,-1
1523,"Global Institute of Engineering and Technology,257/1, Bangalore-Chennai Highway,Melvisharam,Vellore-632509.",EC,ELECTRONICS ANDCOMMUNICATIONENGINEERING,35,36,1
1523,"Global Institute of Engineering and Technology,257/1, Bangalore-Chennai Highway,Melvisharam,Vellore-632509.",EE,ELECTRICAL AND ELECTRONICSENGINEERING,16,19,3
1523,"Global Institute of Engineering and Technology,257/1, Bangalore-Chennai Highway,Melvisharam,Vellore-632509.",IT,INFORMATION TECHNOLOGY,54,51,-3
1523,"Global Institute of Engineering and Technology,257/1, Bangalore-Chennai Highway,Melvisharam,Vellore-632509.",ME,MECHANICAL ENGINEERING,17,18,1
1524,"Annamalaiar College Of Engineering, Chetpet-PolurRoad, Polur Taluk, Thiruvannamalai District-606902.",CE,CIVIL  ENGINEERING,22,25,3
1524,"Annamalaiar College Of Engineering, Chetpet-PolurRoad, Polur Taluk, Thiruvannamalai District-606902.",CS,COMPUTER SCIENCE ANDENGINEERING,45,37,-8
1524,"Annamalaiar College Of Engineering, Chetpet-PolurRoad, Polur Taluk, Thiruvannamalai District-606902.",EC,ELECTRONICS ANDCOMMUNICATIONENGINEERING,22,25,3
1524,"Annamalaiar College Of Engineering, Chetpet-PolurRoad, Polur Taluk, Thiruvannamalai District-606902.",EE,ELECTRICAL AND ELECTRONICSENGINEERING,22,24,2
1524,"Annamalaiar College Of Engineering, Chetpet-PolurRoad, Polur Taluk, Thiruvannamalai District-606902.",IT,INFORMATION TECHNOLOGY,21,24,3
1524,"Annamalaiar College Of Engineering, Chetpet-PolurRoad, Polur Taluk, Thiruvannamalai District-606902.",ME,MECHANICAL ENGINEERING,45,50,5
1525,"Podhigai College of Engineering and Technology,Salem Main Road, Adiyur Post, TirupatturTaluk,Tirupattur, Vellore District.-635601.",CE,CIVIL  ENGINEERING,23,17,-6
1525,"Podhigai College of Engineering and Technology,Salem Main Road, Adiyur Post, TirupatturTaluk,Tirupattur, Vellore District.-635601.",CS,COMPUTER SCIENCE ANDENGINEERING,46,50,4
1525,"Podhigai College of Engineering and Technology,Salem Main Road, Adiyur Post, TirupatturTaluk,Tirupattur, Vellore District.-635601.",EC,ELECTRONICS ANDCOMMUNICATIONENGINEERING,25,24,-1
1525,"Podhigai College of Engineering and Technology,Salem Main Road, Adiyur Post, TirupatturTaluk,Tirupattur, Vellore District.-635601.",EE,ELECTRICAL AND ELECTRONICSENGINEERING,46,44,-2
1525,"Podhigai College of Engineering and Technology,Salem Main Road, Adiyur Post, TirupatturTaluk,Tirupattur, Vellore District.-635601.",IT,INFORMATION TECHNOLOGY,46,50,4
1525,"Podhigai College of Engineering and Technology,Salem Main Road, Adiyur Post, TirupatturTaluk,Tirupattur, Vellore District.-635601.",ME,MECHANICAL ENGINEERING,44,35,-9
1526,"Sri Krishna College of Engineering, T.R.S. Campus, SriKrishna Nagar, Tiruttani Road,Arakkonam, Vellore-631003.",CE,CIVIL  ENGINEERING,18,18,0
1526,"Sri Krishna College of Engineering, T.R.S. Campus, SriKrishna Nagar, Tiruttani Road,Arakkonam, Vellore-631003.",CS,COMPUTER SCIENCE ANDENGINEERING,34,36,2
1526,"Sri Krishna College of Engineering, T.R.S. Campus, SriKrishna Nagar, Tiruttani Road,Arakkonam, Vellore-631003.",EC,ELECTRONICS ANDCOMMUNICATIONENGINEERING,18,18,0
1526,"Sri Krishna College of Engineering, T.R.S. Campus, SriKrishna Nagar, Tiruttani Road,Arakkonam, Vellore-631003.",EE,ELECTRICAL AND ELECTRONICSENGINEERING,18,17,-1
1526,"Sri Krishna College of Engineering, T.R.S. Campus, SriKrishna Nagar, Tiruttani Road,Arakkonam, Vellore-631003.",ME,MECHANICAL ENGINEERING,70,70,0
1529,"Oxford College of Engineering, Venmani Village,Karaipoondi Post, Polur, Tiruvannamalai-606803.",CE,CIVIL  ENGINEERING,54,35,-19
1529,"Oxford College of Engineering, Venmani Village,Karaipoondi Post, Polur, Tiruvannamalai-606803.",CS,COMPUTER SCIENCE ANDENGINEERING,54,36,-18
1529,"Oxford College of Engineering, Venmani Village,Karaipoondi Post, Polur, Tiruvannamalai-606803.",EC,ELECTRONICS ANDCOMMUNICATIONENGINEERING,54,35,-19
1529,"Oxford College of Engineering, Venmani Village,Karaipoondi Post, Polur, Tiruvannamalai-606803.",EE,ELECTRICAL AND ELECTRONICSENGINEERING,54,35,-19
1529,"Oxford College of Engineering, Venmani Village,Karaipoondi Post, Polur, Tiruvannamalai-606803.",ME,MECHANICAL ENGINEERING,55,35,-20
1605,"Idhaya Engineering College for Women,Nainarpalayam Road,Chinna Salem, VillupuramDistrict.-606201.",CS,COMPUTER SCIENCE ANDENGINEERING,63,64,1
1605,"Idhaya Engineering College for Women,Nainarpalayam Road,Chinna Salem, VillupuramDistrict.-606201.",EC,ELECTRONICS ANDCOMMUNICATIONENGINEERING,45,45,0
1605,"Idhaya Engineering College for Women,Nainarpalayam Road,Chinna Salem, VillupuramDistrict.-606201.",EE,ELECTRICAL AND ELECTRONICSENGINEERING,22,22,0
1605,"Idhaya Engineering College for Women,Nainarpalayam Road,Chinna Salem, VillupuramDistrict.-606201.",IT,INFORMATION TECHNOLOGY,46,46,0
2005,Government College of Technology (Autonomous)Thadagam Road  Coimbatore District 641013,CE,CIVIL  ENGINEERING,109,109,0
2005,Government College of Technology (Autonomous)Thadagam Road  Coimbatore District 641013,CS,COMPUTER SCIENCE ANDENGINEERING,51,54,3
2005,Government College of Technology (Autonomous)Thadagam Road  Coimbatore District 641013,EC,ELECTRONICS ANDCOMMUNICATIONENGINEERING,53,53,0
2005,Government College of Technology (Autonomous)Thadagam Road  Coimbatore District 641013,EE,ELECTRICAL AND ELECTRONICSENGINEERING,52,55,3
2005,Government College of Technology (Autonomous)Thadagam Road  Coimbatore District 641013,EI,ELECTRONICS ANDINSTRUMENTATIONENGINEERING,53,55,2
2005,Government College of Technology (Autonomous)Thadagam Road  Coimbatore District 641013,IB,INDUSTRIAL BIO TECHNOLOGY,107,109,2
2005,Government College of Technology (Autonomous)Thadagam Road  Coimbatore District 641013,IT,INFORMATION TECHNOLOGY,52,55,3
2005,Government College of Technology (Autonomous)Thadagam Road  Coimbatore District 641013,ME,MECHANICAL ENGINEERING,109,108,-1
2005,Government College of Technology (Autonomous)Thadagam Road  Coimbatore District 641013,PR,PRODUCTION ENGINEERING,53,55,2
2006,PSG College of Technology (Autonomous)  PeelameduCoimbatore District 641004,AS,AUTOMOBILE ENGINEERING(SS),38,38,0
2006,PSG College of Technology (Autonomous)  PeelameduCoimbatore District 641004,BS,BIO TECHNOLOGY (SS),38,38,0
2006,PSG College of Technology (Autonomous)  PeelameduCoimbatore District 641004,BY,BIO MEDICAL ENGINEERING(SS),38,38,0
2006,PSG College of Technology (Autonomous)  PeelameduCoimbatore District 641004,CE,CIVIL  ENGINEERING,27,27,0
2006,PSG College of Technology (Autonomous)  PeelameduCoimbatore District 641004,CG,Computer Science andEngineering (ArtificialIntelligence and MachineLearning) (SS),38,38,0
2006,PSG College of Technology (Autonomous)  PeelameduCoimbatore District 641004,CM,COMPUTER SCIENCE ANDENGINEERING (SS),85,87,2
2006,PSG College of Technology (Autonomous)  PeelameduCoimbatore District 641004,CN,CIVIL  ENGINEERING (SS),20,19,-1
2006,PSG College of Technology (Autonomous)  PeelameduCoimbatore District 641004,EC,ELECTRONICS ANDCOMMUNICATIONENGINEERING,51,55,4
2006,PSG College of Technology (Autonomous)  PeelameduCoimbatore District 641004,EE,ELECTRICAL AND ELECTRONICSENGINEERING,53,55,2
2006,PSG College of Technology (Autonomous)  PeelameduCoimbatore District 641004,EM,ELECTRONICS ANDCOMMUNICATIONENGINEERING (SS),47,50,3
2006,PSG College of Technology (Autonomous)  PeelameduCoimbatore District 641004,ES,ELECTRICAL AND ELECTRONICS(SANDWICH) (SS),38,38,0
2006,PSG College of Technology (Autonomous)  PeelameduCoimbatore District 641004,FY,FASHION TECHNOLOGY (SS),38,38,0
2006,PSG College of Technology (Autonomous)  PeelameduCoimbatore District 641004,IM,INFORMATION TECHNOLOGY(SS),84,88,4
2006,PSG College of Technology (Autonomous)  PeelameduCoimbatore District 641004,IY,INSTRUMENTATION ANDCONTROL ENGINEERING (SS),38,38,0
2006,PSG College of Technology (Autonomous)  PeelameduCoimbatore District 641004,ME,MECHANICAL ENGINEERING,55,54,-1
2006,PSG College of Technology (Autonomous)  PeelameduCoimbatore District 641004,MF,MECHANICAL ENGINEERING(SS),38,38,0
2006,PSG College of Technology (Autonomous)  PeelameduCoimbatore District 641004,MS,MECHANICAL ENGINEERING(SANDWICH) (SS),38,38,0
2006,PSG College of Technology (Autonomous)  PeelameduCoimbatore District 641004,MT,METALLURGICAL ENGINEERING,27,27,0
2006,PSG College of Technology (Autonomous)  PeelameduCoimbatore District 641004,MY,METALLURGICAL ENGINEERING(SS),19,19,0
2006,PSG College of Technology (Autonomous)  PeelameduCoimbatore District 641004,PN,PRODUCTION ENGINEERING(SS),19,19,0
2006,PSG College of Technology (Autonomous)  PeelameduCoimbatore District 641004,PR,PRODUCTION ENGINEERING,27,27,0
2006,PSG College of Technology (Autonomous)  PeelameduCoimbatore District 641004,PS,PRODUCTION ENGINEERING(SANDWICH) (SS),38,38,0
2006,PSG College of Technology (Autonomous)  PeelameduCoimbatore District 641004,RA,ROBOTICS AND AUTOMATION(SS),38,38,0
2006,PSG College of Technology (Autonomous)  PeelameduCoimbatore District 641004,TT,TEXTILE TECHNOLOGY (SS),19,20,1
2006,PSG College of Technology (Autonomous)  PeelameduCoimbatore District 641004,TX,TEXTILE TECHNOLOGY,26,27,1
2007,Coimbatore Institute of Technology (Autonomous)Civil Aerodrome Post  Coimbatore District 641014,AT,ARTIFICIAL INTELLIGENCE ANDDATA SCIENCE (SS),38,38,0
2007,Coimbatore Institute of Technology (Autonomous)Civil Aerodrome Post  Coimbatore District 641014,CE,CIVIL  ENGINEERING,40,41,1
2007,Coimbatore Institute of Technology (Autonomous)Civil Aerodrome Post  Coimbatore District 641014,CH,CHEMICAL  ENGINEERING,36,36,0
2007,Coimbatore Institute of Technology (Autonomous)Civil Aerodrome Post  Coimbatore District 641014,CL,CHEMICAL  ENGINEERING (SS),13,13,0
2007,Coimbatore Institute of Technology (Autonomous)Civil Aerodrome Post  Coimbatore District 641014,CM,COMPUTER SCIENCE ANDENGINEERING (SS),38,38,0
2007,Coimbatore Institute of Technology (Autonomous)Civil Aerodrome Post  Coimbatore District 641014,CN,CIVIL  ENGINEERING (SS),9,10,1
2007,Coimbatore Institute of Technology (Autonomous)Civil Aerodrome Post  Coimbatore District 641014,CS,COMPUTER SCIENCE ANDENGINEERING,52,55,3
2007,Coimbatore Institute of Technology (Autonomous)Civil Aerodrome Post  Coimbatore District 641014,EC,ELECTRONICS ANDCOMMUNICATIONENGINEERING,54,55,1
2007,Coimbatore Institute of Technology (Autonomous)Civil Aerodrome Post  Coimbatore District 641014,EE,ELECTRICAL AND ELECTRONICSENGINEERING,57,59,2
2007,Coimbatore Institute of Technology (Autonomous)Civil Aerodrome Post  Coimbatore District 641014,EM,ELECTRONICS ANDCOMMUNICATIONENGINEERING (SS),38,38,0
2007,Coimbatore Institute of Technology (Autonomous)Civil Aerodrome Post  Coimbatore District 641014,EY,ELECTRICAL AND ELECTRONICSENGINEERING (SS),35,36,1
2007,Coimbatore Institute of Technology (Autonomous)Civil Aerodrome Post  Coimbatore District 641014,IM,INFORMATION TECHNOLOGY(SS),38,38,0
2007,Coimbatore Institute of Technology (Autonomous)Civil Aerodrome Post  Coimbatore District 641014,ME,MECHANICAL ENGINEERING,59,58,-1
2007,Coimbatore Institute of Technology (Autonomous)Civil Aerodrome Post  Coimbatore District 641014,MF,MECHANICAL ENGINEERING(SS),36,34,-2
2025,Anna University Regional Campus - CoimbatoreMaruthamalai Main Road  Navavoor BharathiyarUniversity Post  Somayampalayam  CoimbatoreDistrict 641046,AD,Artificial Intelligence and DataScience,54,55,1
2025,Anna University Regional Campus - CoimbatoreMaruthamalai Main Road  Navavoor BharathiyarUniversity Post  Somayampalayam  CoimbatoreDistrict 641046,CS,COMPUTER SCIENCE ANDENGINEERING,54,54,0
2025,Anna University Regional Campus - CoimbatoreMaruthamalai Main Road  Navavoor BharathiyarUniversity Post  Somayampalayam  CoimbatoreDistrict 641046,EC,ELECTRONICS ANDCOMMUNICATIONENGINEERING,54,54,0
2025,Anna University Regional Campus - CoimbatoreMaruthamalai Main Road  Navavoor BharathiyarUniversity Post  Somayampalayam  CoimbatoreDistrict 641046,EE,ELECTRICAL AND ELECTRONICSENGINEERING,54,55,1
2025,Anna University Regional Campus - CoimbatoreMaruthamalai Main Road  Navavoor BharathiyarUniversity Post  Somayampalayam  CoimbatoreDistrict 641046,EV,Electronics Engineering (VLSIDesign and Technology),0,27,27
2025,Anna University Regional Campus - CoimbatoreMaruthamalai Main Road  Navavoor BharathiyarUniversity Post  Somayampalayam  CoimbatoreDistrict 641046,ME,MECHANICAL ENGINEERING,55,54,-1
2302,"Sri Shanmugha College of Engineering andTechnology (Autonomous), Pullipalayam, Morur(PO),Sankari Taluk, Salem District-637304.",AD,Artificial Intelligence and DataScience,50,70,20
2302,"Sri Shanmugha College of Engineering andTechnology (Autonomous), Pullipalayam, Morur(PO),Sankari Taluk, Salem District-637304.",AG,AGRICULTURE ENGINEERING,38,35,-3
2302,"Sri Shanmugha College of Engineering andTechnology (Autonomous), Pullipalayam, Morur(PO),Sankari Taluk, Salem District-637304.",BM,BIO MEDICAL ENGINEERING,35,45,10
2302,"Sri Shanmugha College of Engineering andTechnology (Autonomous), Pullipalayam, Morur(PO),Sankari Taluk, Salem District-637304.",CS,COMPUTER SCIENCE ANDENGINEERING,41,36,-5
2302,"Sri Shanmugha College of Engineering andTechnology (Autonomous), Pullipalayam, Morur(PO),Sankari Taluk, Salem District-637304.",EC,ELECTRONICS ANDCOMMUNICATIONENGINEERING,45,45,0
2302,"Sri Shanmugha College of Engineering andTechnology (Autonomous), Pullipalayam, Morur(PO),Sankari Taluk, Salem District-637304.",IT,INFORMATION TECHNOLOGY,50,54,4
2302,"Sri Shanmugha College of Engineering andTechnology (Autonomous), Pullipalayam, Morur(PO),Sankari Taluk, Salem District-637304.",ME,MECHANICAL ENGINEERING,35,35,0
2302,"Sri Shanmugha College of Engineering andTechnology (Autonomous), Pullipalayam, Morur(PO),Sankari Taluk, Salem District-637304.",SC,Computer Science andEngineering (Cyber Security),35,35,0
2314,Muthayammal College of Engineering  Kakkaveri PostNamakkal District 637408,AD,ARTIFICIAL INTELLIGENCEAND DATA SCIENCE,54,0,-54
2314,Muthayammal College of Engineering  Kakkaveri PostNamakkal District 637408,AG,AGRICULTURAL ENGINEERING,55,0,-55
2314,Muthayammal College of Engineering  Kakkaveri PostNamakkal District 637408,CS,COMPUTER SCIENCE ANDENGINEERING,103,0,-103
2314,Muthayammal College of Engineering  Kakkaveri PostNamakkal District 637408,EC,ELECTRONICS ANDCOMMUNICATIONENGINEERING,49,0,-49
2314,Muthayammal College of Engineering  Kakkaveri PostNamakkal District 637408,EE,ELECTRICAL ANDELECTRONICS ENGINEERING,27,0,-27
2327,"N.S.N. College of Engineering and Technology, N.S.N,Kalvi Nagar, Karur - Madurai NH-7, Manalmedu, Karur639003.",AD,Artificial Intelligence and DataScience,55,55,0
2327,"N.S.N. College of Engineering and Technology, N.S.N,Kalvi Nagar, Karur - Madurai NH-7, Manalmedu, Karur639003.",CE,CIVIL  ENGINEERING,27,28,1
2327,"N.S.N. College of Engineering and Technology, N.S.N,Kalvi Nagar, Karur - Madurai NH-7, Manalmedu, Karur639003.",CS,COMPUTER SCIENCE ANDENGINEERING,50,73,23
2327,"N.S.N. College of Engineering and Technology, N.S.N,Kalvi Nagar, Karur - Madurai NH-7, Manalmedu, Karur639003.",EC,ELECTRONICS ANDCOMMUNICATIONENGINEERING,49,72,23
2327,"N.S.N. College of Engineering and Technology, N.S.N,Kalvi Nagar, Karur - Madurai NH-7, Manalmedu, Karur639003.",EE,ELECTRICAL AND ELECTRONICSENGINEERING,27,28,1
2327,"N.S.N. College of Engineering and Technology, N.S.N,Kalvi Nagar, Karur - Madurai NH-7, Manalmedu, Karur639003.",IT,INFORMATION TECHNOLOGY,49,72,23
2327,"N.S.N. College of Engineering and Technology, N.S.N,Kalvi Nagar, Karur - Madurai NH-7, Manalmedu, Karur639003.",ME,MECHANICAL ENGINEERING,54,54,0
2328,K S R Institute for Engineering and Technology(Autonomous) Thokkavadi  Namakkal District 637215,BM,BIO MEDICAL ENGINEERING,35,0,-35
2328,K S R Institute for Engineering and Technology(Autonomous) Thokkavadi  Namakkal District 637215,CS,COMPUTER SCIENCE ANDENGINEERING,54,0,-54
2328,K S R Institute for Engineering and Technology(Autonomous) Thokkavadi  Namakkal District 637215,EC,ELECTRONICS ANDCOMMUNICATIONENGINEERING,35,0,-35
2328,K S R Institute for Engineering and Technology(Autonomous) Thokkavadi  Namakkal District 637215,EE,ELECTRICAL ANDELECTRONICS ENGINEERING,36,0,-36
2328,K S R Institute for Engineering and Technology(Autonomous) Thokkavadi  Namakkal District 637215,IT,INFORMATION TECHNOLOGY,35,0,-35
2328,K S R Institute for Engineering and Technology(Autonomous) Thokkavadi  Namakkal District 637215,ME,MECHANICAL ENGINEERING,46,0,-46
2328,K S R Institute for Engineering and Technology(Autonomous) Thokkavadi  Namakkal District 637215,SC,Computer Science andEngineering (Cyber Security),34,0,-34
2329,"Rathinam Technical Campus (Autonomous), RathinamTechzone Campus, Pollachi Road, Eachanari,Coimbatore-641021.",AD,Artificial Intelligence and DataScience,35,105,70
2329,"Rathinam Technical Campus (Autonomous), RathinamTechzone Campus, Pollachi Road, Eachanari,Coimbatore-641021.",AG,AGRICULTURE ENGINEERING,19,18,-1
2329,"Rathinam Technical Campus (Autonomous), RathinamTechzone Campus, Pollachi Road, Eachanari,Coimbatore-641021.",AM,COMPUTER SCIENCE ANDENGINEERING (AI ANDMACHINE LEARNING),35,70,35
2329,Rathinam Technical Campus  (Autonomous)  PollachiRoad  Eachanari  Coimbatore District 641021,BM,BIO MEDICAL ENGINEERING,18,0,-18
2329,"Rathinam Technical Campus (Autonomous), RathinamTechzone Campus, Pollachi Road, Eachanari,Coimbatore-641021.",BT,BIO TECHNOLOGY,18,35,17
2329,"Rathinam Technical Campus (Autonomous), RathinamTechzone Campus, Pollachi Road, Eachanari,Coimbatore-641021.",CS,COMPUTER SCIENCE ANDENGINEERING,33,106,73
2329,"Rathinam Technical Campus (Autonomous), RathinamTechzone Campus, Pollachi Road, Eachanari,Coimbatore-641021.",EC,ELECTRONICS ANDCOMMUNICATIONENGINEERING,35,36,1
2329,"Rathinam Technical Campus (Autonomous), RathinamTechzone Campus, Pollachi Road, Eachanari,Coimbatore-641021.",IT,INFORMATION TECHNOLOGY,35,71,36
2329,"Rathinam Technical Campus (Autonomous), RathinamTechzone Campus, Pollachi Road, Eachanari,Coimbatore-641021.",ME,MECHANICAL ENGINEERING,18,19,1
2329,"Rathinam Technical Campus (Autonomous), RathinamTechzone Campus, Pollachi Road, Eachanari,Coimbatore-641021.",MZ,Mechatronics Engineering,0,18,18
2329,"Rathinam Technical Campus (Autonomous), RathinamTechzone Campus, Pollachi Road, Eachanari,Coimbatore-641021.",SC,Computer Science andEngineering (Cyber Security),0,70,70
2329,"Rathinam Technical Campus (Autonomous), RathinamTechzone Campus, Pollachi Road, Eachanari,Coimbatore-641021.",XS,COMPUTER SCIENCE ANDENGINEERING (TAMIL),35,36,1
2332,"Aishwarya College of Engineering and Technology,Errattaikarad, Paruvachi (Post), Anthiyur, Bhavani(Taluk), Erode District-638312.",AD,Artificial Intelligence and DataScience,36,35,-1
2332,"Aishwarya College of Engineering and Technology,Errattaikarad, Paruvachi (Post), Anthiyur, Bhavani(Taluk), Erode District-638312.",CE,CIVIL  ENGINEERING,36,35,-1
2332,"Aishwarya College of Engineering and Technology,Errattaikarad, Paruvachi (Post), Anthiyur, Bhavani(Taluk), Erode District-638312.",CS,COMPUTER SCIENCE ANDENGINEERING,35,36,1
2332,"Aishwarya College of Engineering and Technology,Errattaikarad, Paruvachi (Post), Anthiyur, Bhavani(Taluk), Erode District-638312.",EC,ELECTRONICS ANDCOMMUNICATIONENGINEERING,35,35,0
2332,"Aishwarya College of Engineering and Technology,Errattaikarad, Paruvachi (Post), Anthiyur, Bhavani(Taluk), Erode District-638312.",EE,ELECTRICAL AND ELECTRONICSENGINEERING,35,35,0
2332,"Aishwarya College of Engineering and Technology,Errattaikarad, Paruvachi (Post), Anthiyur, Bhavani(Taluk), Erode District-638312.",ME,MECHANICAL ENGINEERING,35,36,1
2338,"Asian College of Engineering and Technology,294/2,Asian College Road, Kondayampalayam, NearSaravanampatti, Coimbatore-641110.",AD,Artificial Intelligence and DataScience,41,42,1
2338,"Asian College of Engineering and Technology,294/2,Asian College Road, Kondayampalayam, NearSaravanampatti, Coimbatore-641110.",AG,AGRICULTURE ENGINEERING,40,53,13
2338,"Asian College of Engineering and Technology,294/2,Asian College Road, Kondayampalayam, NearSaravanampatti, Coimbatore-641110.",BM,BIO MEDICAL ENGINEERING,40,45,5
2338,"Asian College of Engineering and Technology,294/2,Asian College Road, Kondayampalayam, NearSaravanampatti, Coimbatore-641110.",CS,COMPUTER SCIENCE ANDENGINEERING,41,45,4
2338,"Asian College of Engineering and Technology,294/2,Asian College Road, Kondayampalayam, NearSaravanampatti, Coimbatore-641110.",EE,ELECTRICAL AND ELECTRONICSENGINEERING,20,23,3
2338,"Asian College of Engineering and Technology,294/2,Asian College Road, Kondayampalayam, NearSaravanampatti, Coimbatore-641110.",IT,INFORMATION TECHNOLOGY,41,35,-6
2338,"Asian College of Engineering and Technology,294/2,Asian College Road, Kondayampalayam, NearSaravanampatti, Coimbatore-641110.",ME,MECHANICAL ENGINEERING,21,21,0
2341,"Ganesh College of Engineering, Attur Main Road,Mettupatti, Salem-636111.",AD,Artificial Intelligence and DataScience,35,54,19
2341,"Ganesh College of Engineering, Attur Main Road,Mettupatti, Salem-636111.",BM,BIO MEDICAL ENGINEERING,35,54,19
2341,"Ganesh College of Engineering, Attur Main Road,Mettupatti, Salem-636111.",CE,CIVIL  ENGINEERING,18,19,1
2341,"Ganesh College of Engineering, Attur Main Road,Mettupatti, Salem-636111.",CS,COMPUTER SCIENCE ANDENGINEERING,35,54,19
2341,"Ganesh College of Engineering, Attur Main Road,Mettupatti, Salem-636111.",EC,ELECTRONICS ANDCOMMUNICATIONENGINEERING,36,35,-1
2341,"Ganesh College of Engineering, Attur Main Road,Mettupatti, Salem-636111.",EE,ELECTRICAL AND ELECTRONICSENGINEERING,19,18,-1
2341,"Ganesh College of Engineering, Attur Main Road,Mettupatti, Salem-636111.",IT,INFORMATION TECHNOLOGY,35,54,19
2341,"Ganesh College of Engineering, Attur Main Road,Mettupatti, Salem-636111.",ME,MECHANICAL ENGINEERING,35,36,1
2342,"Sri Ranganathar Institute of Engineering andTechnology, S.F No:162, Athipalayam village,Thudiyalur-kovilpalayam Road, Coimbatore-641110.",AD,Artificial Intelligence and DataScience,17,35,18
2342,"Sri Ranganathar Institute of Engineering andTechnology, S.F No:162, Athipalayam village,Thudiyalur-kovilpalayam Road, Coimbatore-641110.",CE,CIVIL  ENGINEERING,25,24,-1
2342,"Sri Ranganathar Institute of Engineering andTechnology, S.F No:162, Athipalayam village,Thudiyalur-kovilpalayam Road, Coimbatore-641110.",CS,COMPUTER SCIENCE ANDENGINEERING,70,87,17
2342,"Sri Ranganathar Institute of Engineering andTechnology, S.F No:162, Athipalayam village,Thudiyalur-kovilpalayam Road, Coimbatore-641110.",EC,ELECTRONICS ANDCOMMUNICATIONENGINEERING,41,36,-5
2342,"Sri Ranganathar Institute of Engineering andTechnology, S.F No:162, Athipalayam village,Thudiyalur-kovilpalayam Road, Coimbatore-641110.",EE,ELECTRICAL AND ELECTRONICSENGINEERING,25,24,-1
2342,"Sri Ranganathar Institute of Engineering andTechnology, S.F No:162, Athipalayam village,Thudiyalur-kovilpalayam Road, Coimbatore-641110.",IT,INFORMATION TECHNOLOGY,36,35,-1
2342,"Sri Ranganathar Institute of Engineering andTechnology, S.F No:162, Athipalayam village,Thudiyalur-kovilpalayam Road, Coimbatore-641110.",ME,MECHANICAL ENGINEERING,26,25,-1
2343,Indian Institute of Handloom Technology  Foulke'sCompound  Thillai Nagar  Salem District 636001,HT,HANDLOOM AND TEXTILETECHNOLOGY,26,27,1
2345,"Dhirajlal Gandhi College of Technology,Sikkanampatty, Opposite to Airport,Omalur Taluk,Salem District-636309.",AD,Artificial Intelligence and DataScience,44,99,55
2345,"Dhirajlal Gandhi College of Technology,Sikkanampatty, Opposite to Airport,Omalur Taluk,Salem District-636309.",AG,AGRICULTURE ENGINEERING,23,23,0
2345,"Dhirajlal Gandhi College of Technology,Sikkanampatty, Opposite to Airport,Omalur Taluk,Salem District-636309.",CE,CIVIL  ENGINEERING,23,23,0
2345,"Dhirajlal Gandhi College of Technology,Sikkanampatty, Opposite to Airport,Omalur Taluk,Salem District-636309.",CS,COMPUTER SCIENCE ANDENGINEERING,110,118,8
2345,"Dhirajlal Gandhi College of Technology,Sikkanampatty, Opposite to Airport,Omalur Taluk,Salem District-636309.",EC,ELECTRONICS ANDCOMMUNICATIONENGINEERING,73,73,0
2345,"Dhirajlal Gandhi College of Technology,Sikkanampatty, Opposite to Airport,Omalur Taluk,Salem District-636309.",EE,ELECTRICAL AND ELECTRONICSENGINEERING,50,49,-1
2345,"Dhirajlal Gandhi College of Technology,Sikkanampatty, Opposite to Airport,Omalur Taluk,Salem District-636309.",IT,INFORMATION TECHNOLOGY,46,45,-1
2345,"Dhirajlal Gandhi College of Technology,Sikkanampatty, Opposite to Airport,Omalur Taluk,Salem District-636309.",ME,MECHANICAL ENGINEERING,22,24,2
2345,"Dhirajlal Gandhi College of Technology,Sikkanampatty, Opposite to Airport,Omalur Taluk,Salem District-636309.",RM,ROBOTICS AND AUTOMATION,23,24,1
2346,"Shree Sathyam College of Engineering andTechnology, Manjakkal Patti, Kuppanur Post, SankariTaluk, Salem District-637301.",AD,Artificial Intelligence and DataScience,35,37,2
2346,"Shree Sathyam College of Engineering andTechnology, Manjakkal Patti, Kuppanur Post, SankariTaluk, Salem District-637301.",BM,BIO MEDICAL ENGINEERING,0,17,17
2346,Shree Sathyam College of Engineering and TechnologyNH-47  Manjakkalpatti  Kuppanur Post  Sankari TalukSalem District 637301,CE,CIVIL  ENGINEERING,19,0,-19
2346,"Shree Sathyam College of Engineering andTechnology, Manjakkal Patti, Kuppanur Post, SankariTaluk, Salem District-637301.",CS,COMPUTER SCIENCE ANDENGINEERING,34,36,2
2346,"Shree Sathyam College of Engineering andTechnology, Manjakkal Patti, Kuppanur Post, SankariTaluk, Salem District-637301.",EC,ELECTRONICS ANDCOMMUNICATIONENGINEERING,18,18,0
2346,"Shree Sathyam College of Engineering andTechnology, Manjakkal Patti, Kuppanur Post, SankariTaluk, Salem District-637301.",EE,ELECTRICAL AND ELECTRONICSENGINEERING,35,18,-17
2346,"Shree Sathyam College of Engineering andTechnology, Manjakkal Patti, Kuppanur Post, SankariTaluk, Salem District-637301.",IT,INFORMATION TECHNOLOGY,0,35,35
2346,"Shree Sathyam College of Engineering andTechnology, Manjakkal Patti, Kuppanur Post, SankariTaluk, Salem District-637301.",ME,MECHANICAL ENGINEERING,35,16,-19
2347,"A V S College of Technology, Attur Main Road, NearAVS College of Arts & Science, Chinnagoundapuram,Salem-636106.",AD,Artificial Intelligence and DataScience,0,36,36
2347,"A V S College of Technology, Attur Main Road, NearAVS College of Arts & Science, Chinnagoundapuram,Salem-636106.",AG,AGRICULTURE ENGINEERING,40,39,-1
2347,"A V S College of Technology, Attur Main Road, NearAVS College of Arts & Science, Chinnagoundapuram,Salem-636106.",CS,COMPUTER SCIENCE ANDENGINEERING,45,76,31
2347,"A V S College of Technology, Attur Main Road, NearAVS College of Arts & Science, Chinnagoundapuram,Salem-636106.",EC,ELECTRONICS ANDCOMMUNICATIONENGINEERING,41,48,7
2347,"A V S College of Technology, Attur Main Road, NearAVS College of Arts & Science, Chinnagoundapuram,Salem-636106.",EE,ELECTRICAL AND ELECTRONICSENGINEERING,45,37,-8
2347,"A V S College of Technology, Attur Main Road, NearAVS College of Arts & Science, Chinnagoundapuram,Salem-636106.",IT,INFORMATION TECHNOLOGY,44,36,-8
2347,"A V S College of Technology, Attur Main Road, NearAVS College of Arts & Science, Chinnagoundapuram,Salem-636106.",ME,MECHANICAL ENGINEERING,49,36,-13
2349,"Dhaanish Ahmed Institute of Technology, PitchanurVillage, Coimbatore-641018.",AD,Artificial Intelligence and DataScience,31,41,10
2349,"Dhaanish Ahmed Institute of Technology, PitchanurVillage, Coimbatore-641018.",AM,COMPUTER SCIENCE ANDENGINEERING (AI ANDMACHINE LEARNING),0,26,26
2349,"Dhaanish Ahmed Institute of Technology, PitchanurVillage, Coimbatore-641018.",BM,BIO MEDICAL ENGINEERING,41,41,0
2349,"Dhaanish Ahmed Institute of Technology, PitchanurVillage, Coimbatore-641018.",CS,COMPUTER SCIENCE ANDENGINEERING,32,41,9
2349,"Dhaanish Ahmed Institute of Technology, PitchanurVillage, Coimbatore-641018.",EC,ELECTRONICS ANDCOMMUNICATIONENGINEERING,0,27,27
2349,"Dhaanish Ahmed Institute of Technology, PitchanurVillage, Coimbatore-641018.",FD,FOOD TECHNOLOGY,41,28,-13
2349,"Dhaanish Ahmed Institute of Technology, PitchanurVillage, Coimbatore-641018.",RM,ROBOTICS AND AUTOMATION,40,41,1
2349,"Dhaanish Ahmed Institute of Technology, PitchanurVillage, Coimbatore-641018.",SC,Computer Science andEngineering (Cyber Security),0,27,27
2350,"Jairupaa College of Engineering, Thottiapalayam,Kathankanni-Po, Kangayam-Tk, Tiruppur-641604.",CE,CIVIL  ENGINEERING,35,35,0
2350,"Jairupaa College of Engineering, Thottiapalayam,Kathankanni-Po, Kangayam-Tk, Tiruppur-641604.",CS,COMPUTER SCIENCE ANDENGINEERING,35,35,0
2350,"Jairupaa College of Engineering, Thottiapalayam,Kathankanni-Po, Kangayam-Tk, Tiruppur-641604.",EC,ELECTRONICS ANDCOMMUNICATIONENGINEERING,36,36,0
2350,"Jairupaa College of Engineering, Thottiapalayam,Kathankanni-Po, Kangayam-Tk, Tiruppur-641604.",EE,ELECTRICAL AND ELECTRONICSENGINEERING,35,35,0
2350,"Jairupaa College of Engineering, Thottiapalayam,Kathankanni-Po, Kangayam-Tk, Tiruppur-641604.",ME,MECHANICAL ENGINEERING,36,36,0
2354,"Pollachi Institute of Engineering and Technology,107/1, Poosaripatti Village, Pollachi to Dharapuramroad, Poosaripatti(post) Pollachi, Coimbatore-642205.",AD,Artificial Intelligence and DataScience,36,41,5
2354,"Pollachi Institute of Engineering and Technology,107/1, Poosaripatti Village, Pollachi to Dharapuramroad, Poosaripatti(post) Pollachi, Coimbatore-642205.",CE,CIVIL  ENGINEERING,17,22,5
2354,"Pollachi Institute of Engineering and Technology,107/1, Poosaripatti Village, Pollachi to Dharapuramroad, Poosaripatti(post) Pollachi, Coimbatore-642205.",CS,COMPUTER SCIENCE ANDENGINEERING,34,41,7
2354,"Pollachi Institute of Engineering and Technology,107/1, Poosaripatti Village, Pollachi to Dharapuramroad, Poosaripatti(post) Pollachi, Coimbatore-642205.",EC,ELECTRONICS ANDCOMMUNICATIONENGINEERING,35,40,5
2354,"Pollachi Institute of Engineering and Technology,107/1, Poosaripatti Village, Pollachi to Dharapuramroad, Poosaripatti(post) Pollachi, Coimbatore-642205.",EE,ELECTRICAL AND ELECTRONICSENGINEERING,18,21,3
2354,"Pollachi Institute of Engineering and Technology,107/1, Poosaripatti Village, Pollachi to Dharapuramroad, Poosaripatti(post) Pollachi, Coimbatore-642205.",ME,MECHANICAL ENGINEERING,35,45,10
2356,"Arulmurugan College of Engineering, Karvazhi Road,Thennilai, Aravakurichy Taluk, Karur-639206.",AD,Artificial Intelligence and DataScience,18,28,10
2356,"Arulmurugan College of Engineering, Karvazhi Road,Thennilai, Aravakurichy Taluk, Karur-639206.",CE,CIVIL  ENGINEERING,27,27,0
2356,"Arulmurugan College of Engineering, Karvazhi Road,Thennilai, Aravakurichy Taluk, Karur-639206.",CS,COMPUTER SCIENCE ANDENGINEERING,34,53,19
2356,"Arulmurugan College of Engineering, Karvazhi Road,Thennilai, Aravakurichy Taluk, Karur-639206.",EC,ELECTRONICS ANDCOMMUNICATIONENGINEERING,27,28,1
2356,"Arulmurugan College of Engineering, Karvazhi Road,Thennilai, Aravakurichy Taluk, Karur-639206.",EE,ELECTRICAL AND ELECTRONICSENGINEERING,28,28,0
2356,"Arulmurugan College of Engineering, Karvazhi Road,Thennilai, Aravakurichy Taluk, Karur-639206.",ME,MECHANICAL ENGINEERING,54,53,-1
2357,"V.S.B. College of Engineering Technical Campus(Autonomous), S.F. No.91/2A,91/2B,252, 253/1,Solavampalayam Village, Kinathukadavu, PollachiTaluk, Coimbatore District-642109.",AD,Artificial Intelligence and DataScience,92,174,82
2357,"V.S.B. College of Engineering Technical Campus(Autonomous), S.F. No.91/2A,91/2B,252, 253/1,Solavampalayam Village, Kinathukadavu, PollachiTaluk, Coimbatore District-642109.",AG,AGRICULTURE ENGINEERING,18,18,0
2357,"V.S.B. College of Engineering Technical Campus(Autonomous), S.F. No.91/2A,91/2B,252, 253/1,Solavampalayam Village, Kinathukadavu, PollachiTaluk, Coimbatore District-642109.",AM,COMPUTER SCIENCE ANDENGINEERING (AI ANDMACHINE LEARNING),0,49,49
2357,V S B College of Engineering Technical Campus  EalurPirivu  Solavampalayam Post  Coimbatore District642109,CE,CIVIL  ENGINEERING,18,0,-18
2357,"V.S.B. College of Engineering Technical Campus(Autonomous), S.F. No.91/2A,91/2B,252, 253/1,Solavampalayam Village, Kinathukadavu, PollachiTaluk, Coimbatore District-642109.",CS,COMPUTER SCIENCE ANDENGINEERING,184,174,-10
2357,"V.S.B. College of Engineering Technical Campus(Autonomous), S.F. No.91/2A,91/2B,252, 253/1,Solavampalayam Village, Kinathukadavu, PollachiTaluk, Coimbatore District-642109.",EC,ELECTRONICS ANDCOMMUNICATIONENGINEERING,92,92,0
2357,"V.S.B. College of Engineering Technical Campus(Autonomous), S.F. No.91/2A,91/2B,252, 253/1,Solavampalayam Village, Kinathukadavu, PollachiTaluk, Coimbatore District-642109.",EE,ELECTRICAL AND ELECTRONICSENGINEERING,17,18,1
2357,"V.S.B. College of Engineering Technical Campus(Autonomous), S.F. No.91/2A,91/2B,252, 253/1,Solavampalayam Village, Kinathukadavu, PollachiTaluk, Coimbatore District-642109.",IT,INFORMATION TECHNOLOGY,41,41,0
2357,"V.S.B. College of Engineering Technical Campus(Autonomous), S.F. No.91/2A,91/2B,252, 253/1,Solavampalayam Village, Kinathukadavu, PollachiTaluk, Coimbatore District-642109.",ME,MECHANICAL ENGINEERING,18,25,7
2360,"Suguna College of Engineering, Nehru Nagar (West),Kalapatti Road, Civil Aerodrome (Post), Coimbatore-641014.",AD,Artificial Intelligence and DataScience,57,65,8
2360,"Suguna College of Engineering, Nehru Nagar (West),Kalapatti Road, Civil Aerodrome (Post), Coimbatore-641014.",AG,AGRICULTURE ENGINEERING,18,23,5
2360,"Suguna College of Engineering, Nehru Nagar (West),Kalapatti Road, Civil Aerodrome (Post), Coimbatore-641014.",CS,COMPUTER SCIENCE ANDENGINEERING,41,44,3
2360,"Suguna College of Engineering, Nehru Nagar (West),Kalapatti Road, Civil Aerodrome (Post), Coimbatore-641014.",EC,ELECTRONICS ANDCOMMUNICATIONENGINEERING,40,43,3
2360,"Suguna College of Engineering, Nehru Nagar (West),Kalapatti Road, Civil Aerodrome (Post), Coimbatore-641014.",IT,INFORMATION TECHNOLOGY,16,22,6
2360,"Suguna College of Engineering, Nehru Nagar (West),Kalapatti Road, Civil Aerodrome (Post), Coimbatore-641014.",ME,MECHANICAL ENGINEERING,18,22,4
2360,"Suguna College of Engineering, Nehru Nagar (West),Kalapatti Road, Civil Aerodrome (Post), Coimbatore-641014.",MZ,Mechatronics Engineering,18,22,4
2367,"Arjun College of Technology, 310/1B,Chettiyakkapalayam, Kinathukadavu, Coimbatore-642120.",AD,Artificial Intelligence and DataScience,35,35,0
2367,"Arjun College of Technology, 310/1B,Chettiyakkapalayam, Kinathukadavu, Coimbatore-642120.",AM,COMPUTER SCIENCE ANDENGINEERING (AI ANDMACHINE LEARNING),0,39,39
2367,"Arjun College of Technology, 310/1B,Chettiyakkapalayam, Kinathukadavu, Coimbatore-642120.",CB,COMPUTER SCIENCE ANDBUSSINESS SYSTEM,35,49,14
2367,"Arjun College of Technology, 310/1B,Chettiyakkapalayam, Kinathukadavu, Coimbatore-642120.",CE,CIVIL  ENGINEERING,18,27,9
2367,"Arjun College of Technology, 310/1B,Chettiyakkapalayam, Kinathukadavu, Coimbatore-642120.",CS,COMPUTER SCIENCE ANDENGINEERING,53,80,27
2367,"Arjun College of Technology, 310/1B,Chettiyakkapalayam, Kinathukadavu, Coimbatore-642120.",EC,ELECTRONICS ANDCOMMUNICATIONENGINEERING,18,23,5
2367,"Arjun College of Technology, 310/1B,Chettiyakkapalayam, Kinathukadavu, Coimbatore-642120.",IT,INFORMATION TECHNOLOGY,34,44,10
2367,"Arjun College of Technology, 310/1B,Chettiyakkapalayam, Kinathukadavu, Coimbatore-642120.",ME,MECHANICAL ENGINEERING,19,27,8
2367,"Arjun College of Technology, 310/1B,Chettiyakkapalayam, Kinathukadavu, Coimbatore-642120.",SC,Computer Science andEngineering (Cyber Security),0,44,44
2368,"Vishnu Lakshmi College of Engineering andTechnology, 10/1,Kambar Street,Kanjikonampalayam, Vellalore(PO), Coimbatore-641111.",CE,CIVIL  ENGINEERING,35,35,0
2368,"Vishnu Lakshmi College of Engineering andTechnology, 10/1,Kambar Street,Kanjikonampalayam, Vellalore(PO), Coimbatore-641111.",CS,COMPUTER SCIENCE ANDENGINEERING,34,35,1
2368,"Vishnu Lakshmi College of Engineering andTechnology, 10/1,Kambar Street,Kanjikonampalayam, Vellalore(PO), Coimbatore-641111.",EC,ELECTRONICS ANDCOMMUNICATIONENGINEERING,36,35,-1
2368,"Vishnu Lakshmi College of Engineering andTechnology, 10/1,Kambar Street,Kanjikonampalayam, Vellalore(PO), Coimbatore-641111.",EE,ELECTRICAL AND ELECTRONICSENGINEERING,36,18,-18
2368,"Vishnu Lakshmi College of Engineering andTechnology, 10/1,Kambar Street,Kanjikonampalayam, Vellalore(PO), Coimbatore-641111.",ME,MECHANICAL ENGINEERING,35,35,0
2369,Government College of Engineering  Chettikkarai PostDharmapuri District 635704,CE,CIVIL  ENGINEERING,55,54,-1
2369,Government College of Engineering  Chettikkarai PostDharmapuri District 635704,CS,COMPUTER SCIENCE ANDENGINEERING,53,55,2
2369,Government College of Engineering  Chettikkarai PostDharmapuri District 635704,EC,ELECTRONICS ANDCOMMUNICATIONENGINEERING,53,55,2
2369,Government College of Engineering  Chettikkarai PostDharmapuri District 635704,EE,ELECTRICAL AND ELECTRONICSENGINEERING,54,54,0
2369,Government College of Engineering  Chettikkarai PostDharmapuri District 635704,ME,MECHANICAL ENGINEERING,54,54,0
2377,"PSG Institute of Technology and Applied Research,Avinashi Road,Neelambur, Sulur,Coimbatore -641062.",AD,Artificial Intelligence and DataScience,34,36,2
2377,PSG Institute of Technology and Applied ResearchAvinashi Road  Neelambur  Coimbatore 641062,CB,COMPUTER SCIENCE ANDBUSSINESS SYSTEM,35,0,-35
2377,"PSG Institute of Technology and Applied Research,Avinashi Road,Neelambur, Sulur,Coimbatore -641062.",CE,CIVIL  ENGINEERING,35,36,1
2377,"PSG Institute of Technology and Applied Research,Avinashi Road,Neelambur, Sulur,Coimbatore -641062.",CS,COMPUTER SCIENCE ANDENGINEERING,35,105,70
2377,"PSG Institute of Technology and Applied Research,Avinashi Road,Neelambur, Sulur,Coimbatore -641062.",EC,ELECTRONICS ANDCOMMUNICATIONENGINEERING,71,70,-1
2377,"PSG Institute of Technology and Applied Research,Avinashi Road,Neelambur, Sulur,Coimbatore -641062.",EE,ELECTRICAL AND ELECTRONICSENGINEERING,35,35,0
2377,"PSG Institute of Technology and Applied Research,Avinashi Road,Neelambur, Sulur,Coimbatore -641062.",IC,INSTRUMENTATION ANDCONTROL ENGINEERING,0,35,35
2377,"PSG Institute of Technology and Applied Research,Avinashi Road,Neelambur, Sulur,Coimbatore -641062.",ME,MECHANICAL ENGINEERING,36,36,0
2378,"Cheran College of Technology, Cheran Nagar,Thittuparai, Kangeyam, Tiruppur-638701.",CS,COMPUTER SCIENCE ANDENGINEERING,36,55,19
2378,"Cheran College of Technology, Cheran Nagar,Thittuparai, Kangeyam, Tiruppur-638701.",EC,ELECTRONICS ANDCOMMUNICATIONENGINEERING,34,54,20
2378,"Cheran College of Technology, Cheran Nagar,Thittuparai, Kangeyam, Tiruppur-638701.",ME,MECHANICAL ENGINEERING,35,55,20
2378,"Cheran College of Technology, Cheran Nagar,Thittuparai, Kangeyam, Tiruppur-638701.",SC,Computer Science andEngineering (Cyber Security),35,53,18
2601,"Adhiyamaan College of Engineering (Autonomous),Aeri Campus, Dr.M.G.R.Nagar, Hosur, KrishnagiriDistrict-635109.",AD,Artificial Intelligence and DataScience,34,36,2
2601,"Adhiyamaan College of Engineering (Autonomous),Aeri Campus, Dr.M.G.R.Nagar, Hosur, KrishnagiriDistrict-635109.",AE,AERONAUTICAL ENGINEERING,45,44,-1
2601,"Adhiyamaan College of Engineering (Autonomous),Aeri Campus, Dr.M.G.R.Nagar, Hosur, KrishnagiriDistrict-635109.",BM,BIO MEDICAL ENGINEERING,44,45,1
2601,"Adhiyamaan College of Engineering (Autonomous),Aeri Campus, Dr.M.G.R.Nagar, Hosur, KrishnagiriDistrict-635109.",BT,BIO TECHNOLOGY,45,45,0
2601,"Adhiyamaan College of Engineering (Autonomous),Aeri Campus, Dr.M.G.R.Nagar, Hosur, KrishnagiriDistrict-635109.",CE,CIVIL  ENGINEERING,55,55,0
2601,"Adhiyamaan College of Engineering (Autonomous),Aeri Campus, Dr.M.G.R.Nagar, Hosur, KrishnagiriDistrict-635109.",CH,CHEMICAL  ENGINEERING,55,55,0
2601,"Adhiyamaan College of Engineering (Autonomous),Aeri Campus, Dr.M.G.R.Nagar, Hosur, KrishnagiriDistrict-635109.",CS,COMPUTER SCIENCE ANDENGINEERING,105,105,0
2601,"Adhiyamaan College of Engineering (Autonomous),Aeri Campus, Dr.M.G.R.Nagar, Hosur, KrishnagiriDistrict-635109.",EC,ELECTRONICS ANDCOMMUNICATIONENGINEERING,106,105,-1
2601,"Adhiyamaan College of Engineering (Autonomous),Aeri Campus, Dr.M.G.R.Nagar, Hosur, KrishnagiriDistrict-635109.",EE,ELECTRICAL AND ELECTRONICSENGINEERING,34,35,1
2601,"Adhiyamaan College of Engineering (Autonomous),Aeri Campus, Dr.M.G.R.Nagar, Hosur, KrishnagiriDistrict-635109.",IT,INFORMATION TECHNOLOGY,34,36,2
2601,"Adhiyamaan College of Engineering (Autonomous),Aeri Campus, Dr.M.G.R.Nagar, Hosur, KrishnagiriDistrict-635109.",ME,MECHANICAL ENGINEERING,35,44,9
2601,"Adhiyamaan College of Engineering (Autonomous),Aeri Campus, Dr.M.G.R.Nagar, Hosur, KrishnagiriDistrict-635109.",SC,Computer Science andEngineering (Cyber Security),0,49,49
2602,"Annai Mathammal Sheela Engineering College,Erumapatty Post, Namakkal-637013.",AD,Artificial Intelligence and DataScience,18,18,0
2602,"Annai Mathammal Sheela Engineering College,Erumapatty Post, Namakkal-637013.",AG,AGRICULTURE ENGINEERING,18,18,0
2602,"Annai Mathammal Sheela Engineering College,Erumapatty Post, Namakkal-637013.",CS,COMPUTER SCIENCE ANDENGINEERING,34,36,2
2602,"Annai Mathammal Sheela Engineering College,Erumapatty Post, Namakkal-637013.",EC,ELECTRONICS ANDCOMMUNICATIONENGINEERING,18,18,0
2602,"Annai Mathammal Sheela Engineering College,Erumapatty Post, Namakkal-637013.",IT,INFORMATION TECHNOLOGY,35,35,0
2602,"Annai Mathammal Sheela Engineering College,Erumapatty Post, Namakkal-637013.",MD,MEDICAL ELECTRONICSENGINEERING,35,35,0
2602,"Annai Mathammal Sheela Engineering College,Erumapatty Post, Namakkal-637013.",ME,MECHANICAL ENGINEERING,18,17,-1
2602,"Annai Mathammal Sheela Engineering College,Erumapatty Post, Namakkal-637013.",RM,ROBOTICS AND AUTOMATION,18,17,-1
2603,Government College of Engineering (Autonomous)Bargur  Krishnagiri District 635104,CS,COMPUTER SCIENCE ANDENGINEERING,52,53,1
2603,Government College of Engineering (Autonomous)Bargur  Krishnagiri District 635104,EC,ELECTRONICS ANDCOMMUNICATIONENGINEERING,53,55,2
2603,Government College of Engineering (Autonomous)Bargur  Krishnagiri District 635104,EE,ELECTRICAL AND ELECTRONICSENGINEERING,54,54,0
2603,Government College of Engineering (Autonomous)Bargur  Krishnagiri District 635104,ME,MECHANICAL ENGINEERING,54,55,1
2607,"K S Rangasamy College of Technology (Autonomous),K.S.R Kalvi Nagar, Thokkavadi, Tiruchengode Tk,Namakkal-637215.",AD,Artificial Intelligence and DataScience,40,45,5
2607,"K S Rangasamy College of Technology (Autonomous),K.S.R Kalvi Nagar, Thokkavadi, Tiruchengode Tk,Namakkal-637215.",AM,COMPUTER SCIENCE ANDENGINEERING (AI ANDMACHINE LEARNING),41,44,3
2607,"K S Rangasamy College of Technology (Autonomous),K.S.R Kalvi Nagar, Thokkavadi, Tiruchengode Tk,Namakkal-637215.",BT,BIO TECHNOLOGY,40,40,0
2607,"K S Rangasamy College of Technology (Autonomous),K.S.R Kalvi Nagar, Thokkavadi, Tiruchengode Tk,Namakkal-637215.",CB,COMPUTER SCIENCE ANDBUSSINESS SYSTEM,41,35,-6
2607,"K S Rangasamy College of Technology (Autonomous),K.S.R Kalvi Nagar, Thokkavadi, Tiruchengode Tk,Namakkal-637215.",CE,CIVIL  ENGINEERING,18,17,-1
2607,"K S Rangasamy College of Technology (Autonomous),K.S.R Kalvi Nagar, Thokkavadi, Tiruchengode Tk,Namakkal-637215.",CS,COMPUTER SCIENCE ANDENGINEERING,75,80,5
2607,"K S Rangasamy College of Technology (Autonomous),K.S.R Kalvi Nagar, Thokkavadi, Tiruchengode Tk,Namakkal-637215.",EC,ELECTRONICS ANDCOMMUNICATIONENGINEERING,81,86,5
2607,"K S Rangasamy College of Technology (Autonomous),K.S.R Kalvi Nagar, Thokkavadi, Tiruchengode Tk,Namakkal-637215.",EE,ELECTRICAL AND ELECTRONICSENGINEERING,41,38,-3
2607,"K S Rangasamy College of Technology (Autonomous),K.S.R Kalvi Nagar, Thokkavadi, Tiruchengode Tk,Namakkal-637215.",EV,Electronics Engineering (VLSIDesign and Technology),35,36,1
2607,"K S Rangasamy College of Technology (Autonomous),K.S.R Kalvi Nagar, Thokkavadi, Tiruchengode Tk,Namakkal-637215.",FD,FOOD TECHNOLOGY,45,35,-10
2607,"K S Rangasamy College of Technology (Autonomous),K.S.R Kalvi Nagar, Thokkavadi, Tiruchengode Tk,Namakkal-637215.",IT,INFORMATION TECHNOLOGY,81,81,0
2607,"K S Rangasamy College of Technology (Autonomous),K.S.R Kalvi Nagar, Thokkavadi, Tiruchengode Tk,Namakkal-637215.",ME,MECHANICAL ENGINEERING,45,38,-7
2607,"K S Rangasamy College of Technology (Autonomous),K.S.R Kalvi Nagar, Thokkavadi, Tiruchengode Tk,Namakkal-637215.",MZ,Mechatronics Engineering,46,38,-8
2607,"K S Rangasamy College of Technology (Autonomous),K.S.R Kalvi Nagar, Thokkavadi, Tiruchengode Tk,Namakkal-637215.",TX,TEXTILE TECHNOLOGY,35,35,0
2608,"M.Kumarasamy College of Engineering(Autonomous), Thalavapalayam Post,PunjaiThottakkurichi Village, Karur Tk, Karur-639113.",AD,Artificial Intelligence and DataScience,84,81,-3
2608,"M.Kumarasamy College of Engineering(Autonomous), Thalavapalayam Post,PunjaiThottakkurichi Village, Karur Tk, Karur-639113.",AM,COMPUTER SCIENCE ANDENGINEERING (AI ANDMACHINE LEARNING),46,36,-10
2608,"M.Kumarasamy College of Engineering(Autonomous), Thalavapalayam Post,PunjaiThottakkurichi Village, Karur Tk, Karur-639113.",CB,COMPUTER SCIENCE ANDBUSSINESS SYSTEM,35,35,0
2608,"M.Kumarasamy College of Engineering(Autonomous), Thalavapalayam Post,PunjaiThottakkurichi Village, Karur Tk, Karur-639113.",CE,CIVIL  ENGINEERING,24,23,-1
2608,"M.Kumarasamy College of Engineering(Autonomous), Thalavapalayam Post,PunjaiThottakkurichi Village, Karur Tk, Karur-639113.",CS,COMPUTER SCIENCE ANDENGINEERING,79,106,27
2608,"M.Kumarasamy College of Engineering(Autonomous), Thalavapalayam Post,PunjaiThottakkurichi Village, Karur Tk, Karur-639113.",EC,ELECTRONICS ANDCOMMUNICATIONENGINEERING,141,141,0
2608,"M.Kumarasamy College of Engineering(Autonomous), Thalavapalayam Post,PunjaiThottakkurichi Village, Karur Tk, Karur-639113.",EE,ELECTRICAL AND ELECTRONICSENGINEERING,71,89,18
2608,"M.Kumarasamy College of Engineering(Autonomous), Thalavapalayam Post,PunjaiThottakkurichi Village, Karur Tk, Karur-639113.",EV,Electronics Engineering (VLSIDesign and Technology),0,45,45
2608,"M.Kumarasamy College of Engineering(Autonomous), Thalavapalayam Post,PunjaiThottakkurichi Village, Karur Tk, Karur-639113.",IT,INFORMATION TECHNOLOGY,81,81,0
2608,"M.Kumarasamy College of Engineering(Autonomous), Thalavapalayam Post,PunjaiThottakkurichi Village, Karur Tk, Karur-639113.",ME,MECHANICAL ENGINEERING,71,72,1
2609,"Mahendra Engineering College (Autonomous),Mahendhirapuri, Mallasamudram West,Vadugapalayam Post,Tiruchengodu Taluk, NamakkalDistrict-637503.",AD,Artificial Intelligence and DataScience,76,105,29
2609,"Mahendra Engineering College (Autonomous),Mahendhirapuri, Mallasamudram West,Vadugapalayam Post,Tiruchengodu Taluk, NamakkalDistrict-637503.",AE,AERONAUTICAL ENGINEERING,35,45,10
2609,"Mahendra Engineering College (Autonomous),Mahendhirapuri, Mallasamudram West,Vadugapalayam Post,Tiruchengodu Taluk, NamakkalDistrict-637503.",AG,AGRICULTURE ENGINEERING,36,39,3
2609,Mahendra Engineering College (Autonomous)Mahendhirapuri  Mallasamudram  Namakkal District637503,AO,AEROSPACE ENGINEERING,35,0,-35
2609,"Mahendra Engineering College (Autonomous),Mahendhirapuri, Mallasamudram West,Vadugapalayam Post,Tiruchengodu Taluk, NamakkalDistrict-637503.",CE,CIVIL  ENGINEERING,72,71,-1
2609,Mahendra Engineering College (Autonomous)Mahendhirapuri  Mallasamudram  Namakkal District637503,CH,CHEMICAL  ENGINEERING,35,0,-35
2609,"Mahendra Engineering College (Autonomous),Mahendhirapuri, Mallasamudram West,Vadugapalayam Post,Tiruchengodu Taluk, NamakkalDistrict-637503.",CS,COMPUTER SCIENCE ANDENGINEERING,111,107,-4
2609,"Mahendra Engineering College (Autonomous),Mahendhirapuri, Mallasamudram West,Vadugapalayam Post,Tiruchengodu Taluk, NamakkalDistrict-637503.",CY,Cyber Security,74,71,-3
2609,"Mahendra Engineering College (Autonomous),Mahendhirapuri, Mallasamudram West,Vadugapalayam Post,Tiruchengodu Taluk, NamakkalDistrict-637503.",EC,ELECTRONICS ANDCOMMUNICATIONENGINEERING,106,124,18
2609,"Mahendra Engineering College (Autonomous),Mahendhirapuri, Mallasamudram West,Vadugapalayam Post,Tiruchengodu Taluk, NamakkalDistrict-637503.",EE,ELECTRICAL AND ELECTRONICSENGINEERING,71,70,-1
2609,Mahendra Engineering College (Autonomous)Mahendhirapuri  Mallasamudram  Namakkal District637503,FD,FOOD TECHNOLOGY,35,0,-35
2609,"Mahendra Engineering College (Autonomous),Mahendhirapuri, Mallasamudram West,Vadugapalayam Post,Tiruchengodu Taluk, NamakkalDistrict-637503.",IT,INFORMATION TECHNOLOGY,83,75,-8
2609,"Mahendra Engineering College (Autonomous),Mahendhirapuri, Mallasamudram West,Vadugapalayam Post,Tiruchengodu Taluk, NamakkalDistrict-637503.",ME,MECHANICAL ENGINEERING,35,49,14
2609,"Mahendra Engineering College (Autonomous),Mahendhirapuri, Mallasamudram West,Vadugapalayam Post,Tiruchengodu Taluk, NamakkalDistrict-637503.",MZ,Mechatronics Engineering,35,49,14
2609,"Mahendra Engineering College (Autonomous),Mahendhirapuri, Mallasamudram West,Vadugapalayam Post,Tiruchengodu Taluk, NamakkalDistrict-637503.",PH,PHARMACEUTICALTECHNOLOGY,35,36,1
2610,"Muthayammal Engineering College (Autonomous),Kakkaveri, Rasipuram (Tk), Namakkal District-637408.",AD,Artificial Intelligence and DataScience,70,108,38
2610,"Muthayammal Engineering College (Autonomous),Kakkaveri, Rasipuram (Tk), Namakkal District-637408.",AG,AGRICULTURE ENGINEERING,0,28,28
2610,"Muthayammal Engineering College (Autonomous),Kakkaveri, Rasipuram (Tk), Namakkal District-637408.",AM,COMPUTER SCIENCE ANDENGINEERING (AI ANDMACHINE LEARNING),55,41,-14
2610,"Muthayammal Engineering College (Autonomous),Kakkaveri, Rasipuram (Tk), Namakkal District-637408.",BM,BIO MEDICAL ENGINEERING,55,55,0
2610,"Muthayammal Engineering College (Autonomous),Kakkaveri, Rasipuram (Tk), Namakkal District-637408.",BT,BIO TECHNOLOGY,55,55,0
2610,"Muthayammal Engineering College (Autonomous),Kakkaveri, Rasipuram (Tk), Namakkal District-637408.",CB,COMPUTER SCIENCE ANDBUSSINESS SYSTEM,54,55,1
2610,"Muthayammal Engineering College (Autonomous),Kakkaveri, Rasipuram (Tk), Namakkal District-637408.",CE,CIVIL  ENGINEERING,27,27,0
2610,"Muthayammal Engineering College (Autonomous),Kakkaveri, Rasipuram (Tk), Namakkal District-637408.",CS,COMPUTER SCIENCE ANDENGINEERING,109,217,108
2610,"Muthayammal Engineering College (Autonomous),Kakkaveri, Rasipuram (Tk), Namakkal District-637408.",EC,ELECTRONICS ANDCOMMUNICATIONENGINEERING,118,191,73
2610,"Muthayammal Engineering College (Autonomous),Kakkaveri, Rasipuram (Tk), Namakkal District-637408.",EE,ELECTRICAL AND ELECTRONICSENGINEERING,109,109,0
2610,"Muthayammal Engineering College (Autonomous),Kakkaveri, Rasipuram (Tk), Namakkal District-637408.",EV,Electronics Engineering (VLSIDesign and Technology),55,53,-2
2610,"Muthayammal Engineering College (Autonomous),Kakkaveri, Rasipuram (Tk), Namakkal District-637408.",IT,INFORMATION TECHNOLOGY,108,109,1
2610,"Muthayammal Engineering College (Autonomous),Kakkaveri, Rasipuram (Tk), Namakkal District-637408.",ME,MECHANICAL ENGINEERING,109,108,-1
2610,"Muthayammal Engineering College (Autonomous),Kakkaveri, Rasipuram (Tk), Namakkal District-637408.",MZ,Mechatronics Engineering,27,28,1
2610,"Muthayammal Engineering College (Autonomous),Kakkaveri, Rasipuram (Tk), Namakkal District-637408.",SC,Computer Science andEngineering (Cyber Security),41,54,13
2611,"Paavai Engineering College (Autonomous), NH-7,Paavai Nagar, Pachal, Namakkal-637018.",AD,Artificial Intelligence and DataScience,34,71,37
2611,"Paavai Engineering College (Autonomous), NH-7,Paavai Nagar, Pachal, Namakkal-637018.",AE,AERONAUTICAL ENGINEERING,52,53,1
2611,"Paavai Engineering College (Autonomous), NH-7,Paavai Nagar, Pachal, Namakkal-637018.",AG,AGRICULTURE ENGINEERING,51,55,4
2611,"Paavai Engineering College (Autonomous), NH-7,Paavai Nagar, Pachal, Namakkal-637018.",AM,COMPUTER SCIENCE ANDENGINEERING (AI ANDMACHINE LEARNING),65,67,2
2611,"Paavai Engineering College (Autonomous), NH-7,Paavai Nagar, Pachal, Namakkal-637018.",BM,BIO MEDICAL ENGINEERING,50,45,-5
2611,"Paavai Engineering College (Autonomous), NH-7,Paavai Nagar, Pachal, Namakkal-637018.",BT,BIO TECHNOLOGY,52,54,2
2611,"Paavai Engineering College (Autonomous), NH-7,Paavai Nagar, Pachal, Namakkal-637018.",CE,CIVIL  ENGINEERING,44,47,3
2611,"Paavai Engineering College (Autonomous), NH-7,Paavai Nagar, Pachal, Namakkal-637018.",CH,CHEMICAL  ENGINEERING,27,25,-2
2611,"Paavai Engineering College (Autonomous), NH-7,Paavai Nagar, Pachal, Namakkal-637018.",CI,Computer Science andEngineering (Internet of Things),52,55,3
2611,"Paavai Engineering College (Autonomous), NH-7,Paavai Nagar, Pachal, Namakkal-637018.",CS,COMPUTER SCIENCE ANDENGINEERING,105,181,76
2611,"Paavai Engineering College (Autonomous), NH-7,Paavai Nagar, Pachal, Namakkal-637018.",CY,Cyber Security,91,102,11
2611,"Paavai Engineering College (Autonomous), NH-7,Paavai Nagar, Pachal, Namakkal-637018.",EC,ELECTRONICS ANDCOMMUNICATIONENGINEERING,139,153,14
2611,"Paavai Engineering College (Autonomous), NH-7,Paavai Nagar, Pachal, Namakkal-637018.",EE,ELECTRICAL AND ELECTRONICSENGINEERING,54,52,-2
2611,"Paavai Engineering College (Autonomous), NH-7,Paavai Nagar, Pachal, Namakkal-637018.",FD,FOOD TECHNOLOGY,51,54,3
2611,"Paavai Engineering College (Autonomous), NH-7,Paavai Nagar, Pachal, Namakkal-637018.",IT,INFORMATION TECHNOLOGY,118,143,25
2611,"Paavai Engineering College (Autonomous), NH-7,Paavai Nagar, Pachal, Namakkal-637018.",ME,MECHANICAL ENGINEERING,52,54,2
2611,"Paavai Engineering College (Autonomous), NH-7,Paavai Nagar, Pachal, Namakkal-637018.",MZ,Mechatronics Engineering,51,54,3
2611,"Paavai Engineering College (Autonomous), NH-7,Paavai Nagar, Pachal, Namakkal-637018.",PH,PHARMACEUTICALTECHNOLOGY,50,52,2
2611,"Paavai Engineering College (Autonomous), NH-7,Paavai Nagar, Pachal, Namakkal-637018.",RM,ROBOTICS AND AUTOMATION,51,54,3
2612,"PGP College of Engineering and Technology,Namakkal-Paramathi NH 7 Road, Namakkal-637207.",AD,Artificial Intelligence and DataScience,22,50,28
2612,"PGP College of Engineering and Technology,Namakkal-Paramathi NH 7 Road, Namakkal-637207.",BM,BIO MEDICAL ENGINEERING,0,50,50
2612,"PGP College of Engineering and Technology,Namakkal-Paramathi NH 7 Road, Namakkal-637207.",CE,CIVIL  ENGINEERING,27,16,-11
2612,"PGP College of Engineering and Technology,Namakkal-Paramathi NH 7 Road, Namakkal-637207.",CS,COMPUTER SCIENCE ANDENGINEERING,77,100,23
2612,"PGP College of Engineering and Technology,Namakkal-Paramathi NH 7 Road, Namakkal-637207.",EC,ELECTRONICS ANDCOMMUNICATIONENGINEERING,50,55,5
2612,"PGP College of Engineering and Technology,Namakkal-Paramathi NH 7 Road, Namakkal-637207.",EE,ELECTRICAL AND ELECTRONICSENGINEERING,26,54,28
2612,"PGP College of Engineering and Technology,Namakkal-Paramathi NH 7 Road, Namakkal-637207.",IT,INFORMATION TECHNOLOGY,50,50,0
2612,"PGP College of Engineering and Technology,Namakkal-Paramathi NH 7 Road, Namakkal-637207.",ME,MECHANICAL ENGINEERING,50,40,-10
2613,"K S R College of Engineering (Autonomous), K S RKalvi Nagar, Thokkavadi, Tiruchengode, NamakkalDist-637215.",AU,AUTOMOBILE ENGINEERING,24,23,-1
2613,"K S R College of Engineering (Autonomous), K S RKalvi Nagar, Thokkavadi, Tiruchengode, NamakkalDist-637215.",BM,BIO MEDICAL ENGINEERING,0,46,46
2613,"K S R College of Engineering (Autonomous), K S RKalvi Nagar, Thokkavadi, Tiruchengode, NamakkalDist-637215.",CD,COMPUTER SCIENCE ANDDESIGN,19,22,3
2613,"K S R College of Engineering (Autonomous), K S RKalvi Nagar, Thokkavadi, Tiruchengode, NamakkalDist-637215.",CE,CIVIL  ENGINEERING,25,24,-1
2613,"K S R College of Engineering (Autonomous), K S RKalvi Nagar, Thokkavadi, Tiruchengode, NamakkalDist-637215.",CI,Computer Science andEngineering (Internet of Things),18,19,1
2613,"K S R College of Engineering (Autonomous), K S RKalvi Nagar, Thokkavadi, Tiruchengode, NamakkalDist-637215.",CS,COMPUTER SCIENCE ANDENGINEERING,70,155,85
2613,"K S R College of Engineering (Autonomous), K S RKalvi Nagar, Thokkavadi, Tiruchengode, NamakkalDist-637215.",EC,ELECTRONICS ANDCOMMUNICATIONENGINEERING,52,89,37
2613,"K S R College of Engineering (Autonomous), K S RKalvi Nagar, Thokkavadi, Tiruchengode, NamakkalDist-637215.",EE,ELECTRICAL AND ELECTRONICSENGINEERING,35,97,62
2613,"K S R College of Engineering (Autonomous), K S RKalvi Nagar, Thokkavadi, Tiruchengode, NamakkalDist-637215.",IT,INFORMATION TECHNOLOGY,35,82,47
2613,"K S R College of Engineering (Autonomous), K S RKalvi Nagar, Thokkavadi, Tiruchengode, NamakkalDist-637215.",ME,MECHANICAL ENGINEERING,49,98,49
2613,"K S R College of Engineering (Autonomous), K S RKalvi Nagar, Thokkavadi, Tiruchengode, NamakkalDist-637215.",SC,Computer Science andEngineering (Cyber Security),0,35,35
2613,"K S R College of Engineering (Autonomous), K S RKalvi Nagar, Thokkavadi, Tiruchengode, NamakkalDist-637215.",SF,Safety and Fire Engineering,24,26,2
2614,"SSM College of Engineering, NH-47 Salem Main Road,Komarapalayam, Namakkal District-638183.",CE,CIVIL  ENGINEERING,17,17,0
2614,"SSM College of Engineering, NH-47 Salem Main Road,Komarapalayam, Namakkal District-638183.",CS,COMPUTER SCIENCE ANDENGINEERING,53,50,-3
2614,"SSM College of Engineering, NH-47 Salem Main Road,Komarapalayam, Namakkal District-638183.",EC,ELECTRONICS ANDCOMMUNICATIONENGINEERING,35,50,15
2614,"SSM College of Engineering, NH-47 Salem Main Road,Komarapalayam, Namakkal District-638183.",EE,ELECTRICAL AND ELECTRONICSENGINEERING,18,27,9
2614,"SSM College of Engineering, NH-47 Salem Main Road,Komarapalayam, Namakkal District-638183.",IT,INFORMATION TECHNOLOGY,55,49,-6
2614,"SSM College of Engineering, NH-47 Salem Main Road,Komarapalayam, Namakkal District-638183.",ME,MECHANICAL ENGINEERING,35,35,0
2614,"SSM College of Engineering, NH-47 Salem Main Road,Komarapalayam, Namakkal District-638183.",PC,PETRO CHEMICALTECHNOLOGY,18,18,0
2614,"SSM College of Engineering, NH-47 Salem Main Road,Komarapalayam, Namakkal District-638183.",PE,PETROLEUM ENGINEERING,18,18,0
2614,"SSM College of Engineering, NH-47 Salem Main Road,Komarapalayam, Namakkal District-638183.",TC,TEXTILE CHEMISTRY,18,19,1
2614,"SSM College of Engineering, NH-47 Salem Main Road,Komarapalayam, Namakkal District-638183.",TX,TEXTILE TECHNOLOGY,35,35,0
2615,Government College of Engineering (Autonomous)Karuppur  Salem District 636011,CE,CIVIL  ENGINEERING,108,109,1
2615,Government College of Engineering (Autonomous)Karuppur  Salem District 636011,CS,COMPUTER SCIENCE ANDENGINEERING,52,54,2
2615,Government College of Engineering (Autonomous)Karuppur  Salem District 636011,EC,ELECTRONICS ANDCOMMUNICATIONENGINEERING,54,55,1
2615,Government College of Engineering (Autonomous)Karuppur  Salem District 636011,EE,ELECTRICAL AND ELECTRONICSENGINEERING,52,54,2
2615,Government College of Engineering (Autonomous)Karuppur  Salem District 636011,ME,MECHANICAL ENGINEERING,109,108,-1
2615,Government College of Engineering (Autonomous)Karuppur  Salem District 636011,MT,METALLURGICAL ENGINEERING,54,55,1
2616,"Sapthagiri College of Engineering, NH-7, KrishnagiriMain Road,Palacode Taluk Periyanahalli Village &Post Dharmapuri District-635205.",AD,Artificial Intelligence and DataScience,28,28,0
2616,"Sapthagiri College of Engineering, NH-7, KrishnagiriMain Road,Palacode Taluk Periyanahalli Village &Post Dharmapuri District-635205.",CE,CIVIL  ENGINEERING,28,27,-1
2616,"Sapthagiri College of Engineering, NH-7, KrishnagiriMain Road,Palacode Taluk Periyanahalli Village &Post Dharmapuri District-635205.",CS,COMPUTER SCIENCE ANDENGINEERING,54,54,0
2616,"Sapthagiri College of Engineering, NH-7, KrishnagiriMain Road,Palacode Taluk Periyanahalli Village &Post Dharmapuri District-635205.",EC,ELECTRONICS ANDCOMMUNICATIONENGINEERING,54,53,-1
2616,"Sapthagiri College of Engineering, NH-7, KrishnagiriMain Road,Palacode Taluk Periyanahalli Village &Post Dharmapuri District-635205.",EE,ELECTRICAL AND ELECTRONICSENGINEERING,27,28,1
2616,"Sapthagiri College of Engineering, NH-7, KrishnagiriMain Road,Palacode Taluk Periyanahalli Village &Post Dharmapuri District-635205.",EI,ELECTRONICS ANDINSTRUMENTATIONENGINEERING,27,27,0
2616,"Sapthagiri College of Engineering, NH-7, KrishnagiriMain Road,Palacode Taluk Periyanahalli Village &Post Dharmapuri District-635205.",IT,INFORMATION TECHNOLOGY,26,28,2
2616,"Sapthagiri College of Engineering, NH-7, KrishnagiriMain Road,Palacode Taluk Periyanahalli Village &Post Dharmapuri District-635205.",ME,MECHANICAL ENGINEERING,55,54,-1
2616,"Sapthagiri College of Engineering, NH-7, KrishnagiriMain Road,Palacode Taluk Periyanahalli Village &Post Dharmapuri District-635205.",SC,Computer Science andEngineering (Cyber Security),27,28,1
2617,"Sengunthar Engineering College (Autonomous),Kosavampalayam, Kumaramangalam(Post),Tiruchengode (Taluk),Namakkal District-637205.",AD,Artificial Intelligence and DataScience,34,45,11
2617,"Sengunthar Engineering College (Autonomous),Kosavampalayam, Kumaramangalam(Post),Tiruchengode (Taluk),Namakkal District-637205.",CE,CIVIL  ENGINEERING,35,35,0
2617,"Sengunthar Engineering College (Autonomous),Kosavampalayam, Kumaramangalam(Post),Tiruchengode (Taluk),Namakkal District-637205.",CS,COMPUTER SCIENCE ANDENGINEERING,54,64,10
2617,"Sengunthar Engineering College (Autonomous),Kosavampalayam, Kumaramangalam(Post),Tiruchengode (Taluk),Namakkal District-637205.",EC,ELECTRONICS ANDCOMMUNICATIONENGINEERING,46,45,-1
2617,"Sengunthar Engineering College (Autonomous),Kosavampalayam, Kumaramangalam(Post),Tiruchengode (Taluk),Namakkal District-637205.",EE,ELECTRICAL AND ELECTRONICSENGINEERING,36,41,5
2617,"Sengunthar Engineering College (Autonomous),Kosavampalayam, Kumaramangalam(Post),Tiruchengode (Taluk),Namakkal District-637205.",IT,INFORMATION TECHNOLOGY,35,45,10
2617,"Sengunthar Engineering College (Autonomous),Kosavampalayam, Kumaramangalam(Post),Tiruchengode (Taluk),Namakkal District-637205.",MD,MEDICAL ELECTRONICSENGINEERING,70,72,2
2617,"Sengunthar Engineering College (Autonomous),Kosavampalayam, Kumaramangalam(Post),Tiruchengode (Taluk),Namakkal District-637205.",ME,MECHANICAL ENGINEERING,35,35,0
2617,"Sengunthar Engineering College (Autonomous),Kosavampalayam, Kumaramangalam(Post),Tiruchengode (Taluk),Namakkal District-637205.",PH,PHARMACEUTICALTECHNOLOGY,17,19,2
2617,"Sengunthar Engineering College (Autonomous),Kosavampalayam, Kumaramangalam(Post),Tiruchengode (Taluk),Namakkal District-637205.",RM,ROBOTICS AND AUTOMATION,36,35,-1
2617,"Sengunthar Engineering College (Autonomous),Kosavampalayam, Kumaramangalam(Post),Tiruchengode (Taluk),Namakkal District-637205.",SC,Computer Science andEngineering (Cyber Security),35,46,11
2618,"Sona College of Technology (Autonomous), SonaNagar, Thiagarajar Polytechnic College Road,Suramangalam (P.O),Salem District-636005.",AD,Artificial Intelligence and DataScience,71,71,0
2618,"Sona College of Technology (Autonomous), SonaNagar, Thiagarajar Polytechnic College Road,Suramangalam (P.O),Salem District-636005.",AM,COMPUTER SCIENCE ANDENGINEERING (AI ANDMACHINE LEARNING),35,36,1
2618,"Sona College of Technology (Autonomous), SonaNagar, Thiagarajar Polytechnic College Road,Suramangalam (P.O),Salem District-636005.",BM,BIO MEDICAL ENGINEERING,35,36,1
2618,"Sona College of Technology (Autonomous), SonaNagar, Thiagarajar Polytechnic College Road,Suramangalam (P.O),Salem District-636005.",CD,COMPUTER SCIENCE ANDDESIGN,35,36,1
2618,"Sona College of Technology (Autonomous), SonaNagar, Thiagarajar Polytechnic College Road,Suramangalam (P.O),Salem District-636005.",CE,CIVIL  ENGINEERING,35,35,0
2618,"Sona College of Technology (Autonomous), SonaNagar, Thiagarajar Polytechnic College Road,Suramangalam (P.O),Salem District-636005.",CS,COMPUTER SCIENCE ANDENGINEERING,105,105,0
2618,"Sona College of Technology (Autonomous), SonaNagar, Thiagarajar Polytechnic College Road,Suramangalam (P.O),Salem District-636005.",EC,ELECTRONICS ANDCOMMUNICATIONENGINEERING,107,105,-2
2618,"Sona College of Technology (Autonomous), SonaNagar, Thiagarajar Polytechnic College Road,Suramangalam (P.O),Salem District-636005.",EE,ELECTRICAL AND ELECTRONICSENGINEERING,70,71,1
2618,"Sona College of Technology (Autonomous), SonaNagar, Thiagarajar Polytechnic College Road,Suramangalam (P.O),Salem District-636005.",EF,Electrical and ComputerEngineering,0,35,35
2618,"Sona College of Technology (Autonomous), SonaNagar, Thiagarajar Polytechnic College Road,Suramangalam (P.O),Salem District-636005.",EX,Electronics and ComputerEngineering,0,36,36
2618,"Sona College of Technology (Autonomous), SonaNagar, Thiagarajar Polytechnic College Road,Suramangalam (P.O),Salem District-636005.",FT,FASHION TECHNOLOGY,35,36,1
2618,"Sona College of Technology (Autonomous), SonaNagar, Thiagarajar Polytechnic College Road,Suramangalam (P.O),Salem District-636005.",IT,INFORMATION TECHNOLOGY,71,70,-1
2618,"Sona College of Technology (Autonomous), SonaNagar, Thiagarajar Polytechnic College Road,Suramangalam (P.O),Salem District-636005.",ME,MECHANICAL ENGINEERING,71,70,-1
2618,"Sona College of Technology (Autonomous), SonaNagar, Thiagarajar Polytechnic College Road,Suramangalam (P.O),Salem District-636005.",MZ,Mechatronics Engineering,35,36,1
2620,"Vivekanandha College of Engineering for Women(Autonomous), Sathiyanaickenpalayam Village,Elayampalayam, Tiruchengode, Namakkal District-637205.",AD,Artificial Intelligence and DataScience,0,36,36
2620,"Vivekanandha College of Engineering for Women(Autonomous), Sathiyanaickenpalayam Village,Elayampalayam, Tiruchengode, Namakkal District-637205.",AG,AGRICULTURE ENGINEERING,0,24,24
2620,"Vivekanandha College of Engineering for Women(Autonomous), Sathiyanaickenpalayam Village,Elayampalayam, Tiruchengode, Namakkal District-637205.",BM,BIO MEDICAL ENGINEERING,41,38,-3
2620,"Vivekanandha College of Engineering for Women(Autonomous), Sathiyanaickenpalayam Village,Elayampalayam, Tiruchengode, Namakkal District-637205.",BT,BIO TECHNOLOGY,44,42,-2
2620,"Vivekanandha College of Engineering for Women(Autonomous), Sathiyanaickenpalayam Village,Elayampalayam, Tiruchengode, Namakkal District-637205.",CE,CIVIL  ENGINEERING,0,28,28
2620,"Vivekanandha College of Engineering for Women(Autonomous), Sathiyanaickenpalayam Village,Elayampalayam, Tiruchengode, Namakkal District-637205.",CS,COMPUTER SCIENCE ANDENGINEERING,70,141,71
2620,"Vivekanandha College of Engineering for Women(Autonomous), Sathiyanaickenpalayam Village,Elayampalayam, Tiruchengode, Namakkal District-637205.",EC,ELECTRONICS ANDCOMMUNICATIONENGINEERING,70,105,35
2620,"Vivekanandha College of Engineering for Women(Autonomous), Sathiyanaickenpalayam Village,Elayampalayam, Tiruchengode, Namakkal District-637205.",EE,ELECTRICAL AND ELECTRONICSENGINEERING,49,49,0
2620,"Vivekanandha College of Engineering for Women(Autonomous), Sathiyanaickenpalayam Village,Elayampalayam, Tiruchengode, Namakkal District-637205.",IT,INFORMATION TECHNOLOGY,35,70,35
2620,"Vivekanandha College of Engineering for Women(Autonomous), Sathiyanaickenpalayam Village,Elayampalayam, Tiruchengode, Namakkal District-637205.",TS,Computer Science andTechnology,35,36,1
2621,"Er. Perumal Manimekalai College of Engineering(Autonomous), 17th Km Hosur - Krishnagiri NH7,Nallaganakothapalli, Near Koneripalli, Hosur Taluk,Krishnagiri District-635117.",AD,Artificial Intelligence and DataScience,43,87,44
2621,"Er. Perumal Manimekalai College of Engineering(Autonomous), 17th Km Hosur - Krishnagiri NH7,Nallaganakothapalli, Near Koneripalli, Hosur Taluk,Krishnagiri District-635117.",AE,AERONAUTICAL ENGINEERING,50,50,0
2621,"Er. Perumal Manimekalai College of Engineering(Autonomous), 17th Km Hosur - Krishnagiri NH7,Nallaganakothapalli, Near Koneripalli, Hosur Taluk,Krishnagiri District-635117.",CB,COMPUTER SCIENCE ANDBUSSINESS SYSTEM,45,50,5
2621,"Er. Perumal Manimekalai College of Engineering(Autonomous), 17th Km Hosur - Krishnagiri NH7,Nallaganakothapalli, Near Koneripalli, Hosur Taluk,Krishnagiri District-635117.",CE,CIVIL  ENGINEERING,27,50,23
2621,"Er. Perumal Manimekalai College of Engineering(Autonomous), 17th Km Hosur - Krishnagiri NH7,Nallaganakothapalli, Near Koneripalli, Hosur Taluk,Krishnagiri District-635117.",CH,CHEMICAL  ENGINEERING,45,53,8
2621,"Er. Perumal Manimekalai College of Engineering(Autonomous), 17th Km Hosur - Krishnagiri NH7,Nallaganakothapalli, Near Koneripalli, Hosur Taluk,Krishnagiri District-635117.",CS,COMPUTER SCIENCE ANDENGINEERING,91,87,-4
2621,"Er. Perumal Manimekalai College of Engineering(Autonomous), 17th Km Hosur - Krishnagiri NH7,Nallaganakothapalli, Near Koneripalli, Hosur Taluk,Krishnagiri District-635117.",EC,ELECTRONICS ANDCOMMUNICATIONENGINEERING,100,100,0
2621,"Er. Perumal Manimekalai College of Engineering(Autonomous), 17th Km Hosur - Krishnagiri NH7,Nallaganakothapalli, Near Koneripalli, Hosur Taluk,Krishnagiri District-635117.",EE,ELECTRICAL AND ELECTRONICSENGINEERING,50,53,3
2621,"Er. Perumal Manimekalai College of Engineering(Autonomous), 17th Km Hosur - Krishnagiri NH7,Nallaganakothapalli, Near Koneripalli, Hosur Taluk,Krishnagiri District-635117.",IT,INFORMATION TECHNOLOGY,95,96,1
2621,"Er. Perumal Manimekalai College of Engineering(Autonomous), 17th Km Hosur - Krishnagiri NH7,Nallaganakothapalli, Near Koneripalli, Hosur Taluk,Krishnagiri District-635117.",ME,MECHANICAL ENGINEERING,54,105,51
2621,"Er. Perumal Manimekalai College of Engineering(Autonomous), 17th Km Hosur - Krishnagiri NH7,Nallaganakothapalli, Near Koneripalli, Hosur Taluk,Krishnagiri District-635117.",MZ,Mechatronics Engineering,50,52,2
2622,"V S B Engineering College (Autonomous), N.H.67,Covai Road, Karudayampalayam (Village & Post),Aravakurichi (TK), Karur-639111.",AD,Artificial Intelligence and DataScience,69,159,90
2622,"V S B Engineering College (Autonomous), N.H.67,Covai Road, Karudayampalayam (Village & Post),Aravakurichi (TK), Karur-639111.",AM,COMPUTER SCIENCE ANDENGINEERING (AI ANDMACHINE LEARNING),35,87,52
2622,"V S B Engineering College (Autonomous), N.H.67,Covai Road, Karudayampalayam (Village & Post),Aravakurichi (TK), Karur-639111.",BM,BIO MEDICAL ENGINEERING,35,18,-17
2622,"V S B Engineering College (Autonomous), N.H.67,Covai Road, Karudayampalayam (Village & Post),Aravakurichi (TK), Karur-639111.",BT,BIO TECHNOLOGY,35,18,-17
2622,"V S B Engineering College (Autonomous), N.H.67,Covai Road, Karudayampalayam (Village & Post),Aravakurichi (TK), Karur-639111.",CB,COMPUTER SCIENCE ANDBUSSINESS SYSTEM,46,36,-10
2622,"V S B Engineering College (Autonomous), N.H.67,Covai Road, Karudayampalayam (Village & Post),Aravakurichi (TK), Karur-639111.",CE,CIVIL  ENGINEERING,18,16,-2
2622,"V S B Engineering College (Autonomous), N.H.67,Covai Road, Karudayampalayam (Village & Post),Aravakurichi (TK), Karur-639111.",CH,CHEMICAL  ENGINEERING,18,24,6
2622,"V S B Engineering College (Autonomous), N.H.67,Covai Road, Karudayampalayam (Village & Post),Aravakurichi (TK), Karur-639111.",CO,COMPUTER ANDCOMMUNICATIONENGINEERING,45,46,1
2622,"V S B Engineering College (Autonomous), N.H.67,Covai Road, Karudayampalayam (Village & Post),Aravakurichi (TK), Karur-639111.",CS,COMPUTER SCIENCE ANDENGINEERING,105,106,1
2622,"V S B Engineering College (Autonomous), N.H.67,Covai Road, Karudayampalayam (Village & Post),Aravakurichi (TK), Karur-639111.",EC,ELECTRONICS ANDCOMMUNICATIONENGINEERING,142,187,45
2622,"V S B Engineering College (Autonomous), N.H.67,Covai Road, Karudayampalayam (Village & Post),Aravakurichi (TK), Karur-639111.",EE,ELECTRICAL AND ELECTRONICSENGINEERING,35,35,0
2622,"V S B Engineering College (Autonomous), N.H.67,Covai Road, Karudayampalayam (Village & Post),Aravakurichi (TK), Karur-639111.",IT,INFORMATION TECHNOLOGY,106,126,20
2622,"V S B Engineering College (Autonomous), N.H.67,Covai Road, Karudayampalayam (Village & Post),Aravakurichi (TK), Karur-639111.",ME,MECHANICAL ENGINEERING,54,47,-7
2623,"Mahendra College of Engineering, 12th KM AtturMain Road, Minnampalli, Salem-636106.",AD,Artificial Intelligence and DataScience,40,74,34
2623,"Mahendra College of Engineering, 12th KM AtturMain Road, Minnampalli, Salem-636106.",BM,BIO MEDICAL ENGINEERING,35,36,1
2623,"Mahendra College of Engineering, 12th KM AtturMain Road, Minnampalli, Salem-636106.",CS,COMPUTER SCIENCE ANDENGINEERING,116,111,-5
2623,"Mahendra College of Engineering, 12th KM AtturMain Road, Minnampalli, Salem-636106.",EC,ELECTRONICS ANDCOMMUNICATIONENGINEERING,80,37,-43
2623,Mahendra College of Engineering  Attur RoadMinnampalli  Valapady  Salem District 636106,EE,ELECTRICAL ANDELECTRONICS ENGINEERING,35,0,-35
2623,"Mahendra College of Engineering, 12th KM AtturMain Road, Minnampalli, Salem-636106.",IT,INFORMATION TECHNOLOGY,70,74,4
2623,Mahendra College of Engineering  Attur RoadMinnampalli  Valapady  Salem District 636106,ME,MECHANICAL ENGINEERING,35,0,-35
2624,"Gnanamani College of Technology (Autonomous), NH-7, A.K. Samuthiram, Pachal Post, Namakkal District-637018.",AD,Artificial Intelligence and DataScience,54,55,1
2624,"Gnanamani College of Technology (Autonomous), NH-7, A.K. Samuthiram, Pachal Post, Namakkal District-637018.",AG,AGRICULTURE ENGINEERING,40,45,5
2624,"Gnanamani College of Technology (Autonomous), NH-7, A.K. Samuthiram, Pachal Post, Namakkal District-637018.",BM,BIO MEDICAL ENGINEERING,54,64,10
2624,"Gnanamani College of Technology (Autonomous), NH-7, A.K. Samuthiram, Pachal Post, Namakkal District-637018.",BT,BIO TECHNOLOGY,28,36,8
2624,"Gnanamani College of Technology (Autonomous), NH-7, A.K. Samuthiram, Pachal Post, Namakkal District-637018.",CH,CHEMICAL  ENGINEERING,41,45,4
2624,"Gnanamani College of Technology (Autonomous), NH-7, A.K. Samuthiram, Pachal Post, Namakkal District-637018.",CS,COMPUTER SCIENCE ANDENGINEERING,81,127,46
2624,"Gnanamani College of Technology (Autonomous), NH-7, A.K. Samuthiram, Pachal Post, Namakkal District-637018.",EC,ELECTRONICS ANDCOMMUNICATIONENGINEERING,82,109,27
2624,"Gnanamani College of Technology (Autonomous), NH-7, A.K. Samuthiram, Pachal Post, Namakkal District-637018.",EE,ELECTRICAL AND ELECTRONICSENGINEERING,27,54,27
2624,"Gnanamani College of Technology (Autonomous), NH-7, A.K. Samuthiram, Pachal Post, Namakkal District-637018.",FD,FOOD TECHNOLOGY,40,45,5
2624,"Gnanamani College of Technology (Autonomous), NH-7, A.K. Samuthiram, Pachal Post, Namakkal District-637018.",IT,INFORMATION TECHNOLOGY,136,136,0
2624,"Gnanamani College of Technology (Autonomous), NH-7, A.K. Samuthiram, Pachal Post, Namakkal District-637018.",ME,MECHANICAL ENGINEERING,36,55,19
2624,"Gnanamani College of Technology (Autonomous), NH-7, A.K. Samuthiram, Pachal Post, Namakkal District-637018.",PH,PHARMACEUTICALTECHNOLOGY,41,45,4
2625,"The Kavery Engineering College, M. Kalipatti, Mecheri(Post), Mettur Taluk, Salem District-636453.",AD,Artificial Intelligence and DataScience,35,37,2
2625,"The Kavery Engineering College, M. Kalipatti, Mecheri(Post), Mettur Taluk, Salem District-636453.",AG,AGRICULTURE ENGINEERING,35,35,0
2625,"The Kavery Engineering College, M. Kalipatti, Mecheri(Post), Mettur Taluk, Salem District-636453.",BM,BIO MEDICAL ENGINEERING,35,35,0
2625,"The Kavery Engineering College, M. Kalipatti, Mecheri(Post), Mettur Taluk, Salem District-636453.",CE,CIVIL  ENGINEERING,18,17,-1
2625,"The Kavery Engineering College, M. Kalipatti, Mecheri(Post), Mettur Taluk, Salem District-636453.",CH,CHEMICAL  ENGINEERING,18,17,-1
2625,"The Kavery Engineering College, M. Kalipatti, Mecheri(Post), Mettur Taluk, Salem District-636453.",CS,COMPUTER SCIENCE ANDENGINEERING,106,131,25
2625,"The Kavery Engineering College, M. Kalipatti, Mecheri(Post), Mettur Taluk, Salem District-636453.",EC,ELECTRONICS ANDCOMMUNICATIONENGINEERING,35,36,1
2625,"The Kavery Engineering College, M. Kalipatti, Mecheri(Post), Mettur Taluk, Salem District-636453.",EE,ELECTRICAL AND ELECTRONICSENGINEERING,35,44,9
2625,"The Kavery Engineering College, M. Kalipatti, Mecheri(Post), Mettur Taluk, Salem District-636453.",IT,INFORMATION TECHNOLOGY,72,86,14
2625,"The Kavery Engineering College, M. Kalipatti, Mecheri(Post), Mettur Taluk, Salem District-636453.",ME,MECHANICAL ENGINEERING,35,43,8
2627,"Selvam College of Technology (Autonomous), SalemRoad NH-7, Pappinaickenpatti (Post), PonnusamyNagar, Namakkal (Tk & Dt)-637003.",AD,Artificial Intelligence and DataScience,27,28,1
2627,"Selvam College of Technology (Autonomous), SalemRoad NH-7, Pappinaickenpatti (Post), PonnusamyNagar, Namakkal (Tk & Dt)-637003.",BM,BIO MEDICAL ENGINEERING,55,55,0
2627,"Selvam College of Technology (Autonomous), SalemRoad NH-7, Pappinaickenpatti (Post), PonnusamyNagar, Namakkal (Tk & Dt)-637003.",BT,BIO TECHNOLOGY,55,53,-2
2627,"Selvam College of Technology (Autonomous), SalemRoad NH-7, Pappinaickenpatti (Post), PonnusamyNagar, Namakkal (Tk & Dt)-637003.",CE,CIVIL  ENGINEERING,27,27,0
2627,"Selvam College of Technology (Autonomous), SalemRoad NH-7, Pappinaickenpatti (Post), PonnusamyNagar, Namakkal (Tk & Dt)-637003.",CS,COMPUTER SCIENCE ANDENGINEERING,54,54,0
2627,"Selvam College of Technology (Autonomous), SalemRoad NH-7, Pappinaickenpatti (Post), PonnusamyNagar, Namakkal (Tk & Dt)-637003.",EC,ELECTRONICS ANDCOMMUNICATIONENGINEERING,54,55,1
2627,"Selvam College of Technology (Autonomous), SalemRoad NH-7, Pappinaickenpatti (Post), PonnusamyNagar, Namakkal (Tk & Dt)-637003.",EE,ELECTRICAL AND ELECTRONICSENGINEERING,54,54,0
2627,"Selvam College of Technology (Autonomous), SalemRoad NH-7, Pappinaickenpatti (Post), PonnusamyNagar, Namakkal (Tk & Dt)-637003.",IT,INFORMATION TECHNOLOGY,55,55,0
2627,"Selvam College of Technology (Autonomous), SalemRoad NH-7, Pappinaickenpatti (Post), PonnusamyNagar, Namakkal (Tk & Dt)-637003.",ME,MECHANICAL ENGINEERING,53,54,1
2628,"Paavai College of Engineering, Paavai Nagar, NH-7,Pachal, Namakkal-637018.",AD,Artificial Intelligence and DataScience,37,35,-2
2628,"Paavai College of Engineering, Paavai Nagar, NH-7,Pachal, Namakkal-637018.",AM,COMPUTER SCIENCE ANDENGINEERING (AI ANDMACHINE LEARNING),54,53,-1
2628,"Paavai College of Engineering, Paavai Nagar, NH-7,Pachal, Namakkal-637018.",AU,AUTOMOBILE ENGINEERING,27,28,1
2628,"Paavai College of Engineering, Paavai Nagar, NH-7,Pachal, Namakkal-637018.",BM,BIO MEDICAL ENGINEERING,54,53,-1
2628,"Paavai College of Engineering, Paavai Nagar, NH-7,Pachal, Namakkal-637018.",CS,COMPUTER SCIENCE ANDENGINEERING,101,109,8
2628,"Paavai College of Engineering, Paavai Nagar, NH-7,Pachal, Namakkal-637018.",EC,ELECTRONICS ANDCOMMUNICATIONENGINEERING,0,54,54
2628,"Paavai College of Engineering, Paavai Nagar, NH-7,Pachal, Namakkal-637018.",EE,ELECTRICAL AND ELECTRONICSENGINEERING,54,53,-1
2628,"Paavai College of Engineering, Paavai Nagar, NH-7,Pachal, Namakkal-637018.",ME,MECHANICAL ENGINEERING,27,28,1
2628,"Paavai College of Engineering, Paavai Nagar, NH-7,Pachal, Namakkal-637018.",SC,Computer Science andEngineering (Cyber Security),52,51,-1
2630,"Chettinad College of Engineering and Technology, NH-67, Karur to Trichy Highways, Puliyur CF, Karur-639114.",AD,Artificial Intelligence and DataScience,35,35,0
2630,"Chettinad College of Engineering and Technology, NH-67, Karur to Trichy Highways, Puliyur CF, Karur-639114.",CS,COMPUTER SCIENCE ANDENGINEERING,34,35,1
2630,"Chettinad College of Engineering and Technology, NH-67, Karur to Trichy Highways, Puliyur CF, Karur-639114.",EC,ELECTRONICS ANDCOMMUNICATIONENGINEERING,36,35,-1
2630,"Chettinad College of Engineering and Technology, NH-67, Karur to Trichy Highways, Puliyur CF, Karur-639114.",EE,ELECTRICAL AND ELECTRONICSENGINEERING,36,35,-1
2630,"Chettinad College of Engineering and Technology, NH-67, Karur to Trichy Highways, Puliyur CF, Karur-639114.",IT,INFORMATION TECHNOLOGY,0,36,36
2630,"Chettinad College of Engineering and Technology, NH-67, Karur to Trichy Highways, Puliyur CF, Karur-639114.",ME,MECHANICAL ENGINEERING,35,36,1
2632,"Mahendra Institute of Technology (Autonomous),Mahendhirapuri, Mallasamudram West,Vadugapalayam Post, Tiruchengodu Taluk, NamakkalDistrict-637503.",AM,COMPUTER SCIENCE ANDENGINEERING (AI ANDMACHINE LEARNING),35,71,36
2632,Mahendra Institute of Technology (Autonomous)Mahendhirapuri  Mallasamudram   Namakkal District637503,AU,AUTOMOBILE ENGINEERING,35,0,-35
2632,"Mahendra Institute of Technology (Autonomous),Mahendhirapuri, Mallasamudram West,Vadugapalayam Post, Tiruchengodu Taluk, NamakkalDistrict-637503.",BM,BIO MEDICAL ENGINEERING,35,49,14
2632,"Mahendra Institute of Technology (Autonomous),Mahendhirapuri, Mallasamudram West,Vadugapalayam Post, Tiruchengodu Taluk, NamakkalDistrict-637503.",CS,COMPUTER SCIENCE ANDENGINEERING,158,142,-16
2632,"Mahendra Institute of Technology (Autonomous),Mahendhirapuri, Mallasamudram West,Vadugapalayam Post, Tiruchengodu Taluk, NamakkalDistrict-637503.",EC,ELECTRONICS ANDCOMMUNICATIONENGINEERING,72,71,-1
2632,"Mahendra Institute of Technology (Autonomous),Mahendhirapuri, Mallasamudram West,Vadugapalayam Post, Tiruchengodu Taluk, NamakkalDistrict-637503.",EE,ELECTRICAL AND ELECTRONICSENGINEERING,35,35,0
2632,"Mahendra Institute of Technology (Autonomous),Mahendhirapuri, Mallasamudram West,Vadugapalayam Post, Tiruchengodu Taluk, NamakkalDistrict-637503.",IT,INFORMATION TECHNOLOGY,35,77,42
2632,Mahendra Institute of Technology (Autonomous)Mahendhirapuri  Mallasamudram   Namakkal District637503,ME,MECHANICAL ENGINEERING,142,0,-142
2633,"Vidyaa Vikas College of Engineering and Technology,Varahoorampatti Village, Tiruchengode Taluk,Namakkal-637214.",AD,Artificial Intelligence and DataScience,27,28,1
2633,"Vidyaa Vikas College of Engineering and Technology,Varahoorampatti Village, Tiruchengode Taluk,Namakkal-637214.",CS,COMPUTER SCIENCE ANDENGINEERING,54,54,0
2633,"Vidyaa Vikas College of Engineering and Technology,Varahoorampatti Village, Tiruchengode Taluk,Namakkal-637214.",EC,ELECTRONICS ANDCOMMUNICATIONENGINEERING,108,108,0
2633,"Vidyaa Vikas College of Engineering and Technology,Varahoorampatti Village, Tiruchengode Taluk,Namakkal-637214.",EE,ELECTRICAL AND ELECTRONICSENGINEERING,55,54,-1
2633,"Vidyaa Vikas College of Engineering and Technology,Varahoorampatti Village, Tiruchengode Taluk,Namakkal-637214.",ME,MECHANICAL ENGINEERING,27,27,0
2633,"Vidyaa Vikas College of Engineering and Technology,Varahoorampatti Village, Tiruchengode Taluk,Namakkal-637214.",SC,Computer Science andEngineering (Cyber Security),27,28,1
2634,"Excel Engineering College (Autonomous), NH-47Salem Main Road, Sankari West Post, TiruchengodeTaluk, Pallakapalayam,  Namakkal District-637303.",AD,Artificial Intelligence and DataScience,71,70,-1
2634,"Excel Engineering College (Autonomous), NH-47Salem Main Road, Sankari West Post, TiruchengodeTaluk, Pallakapalayam,  Namakkal District-637303.",AE,AERONAUTICAL ENGINEERING,35,35,0
2634,"Excel Engineering College (Autonomous), NH-47Salem Main Road, Sankari West Post, TiruchengodeTaluk, Pallakapalayam,  Namakkal District-637303.",AG,AGRICULTURE ENGINEERING,35,36,1
2634,"Excel Engineering College (Autonomous), NH-47Salem Main Road, Sankari West Post, TiruchengodeTaluk, Pallakapalayam,  Namakkal District-637303.",BM,BIO MEDICAL ENGINEERING,44,80,36
2634,"Excel Engineering College (Autonomous), NH-47Salem Main Road, Sankari West Post, TiruchengodeTaluk, Pallakapalayam,  Namakkal District-637303.",CB,COMPUTER SCIENCE ANDBUSSINESS SYSTEM,45,36,-9
2634,"Excel Engineering College (Autonomous), NH-47Salem Main Road, Sankari West Post, TiruchengodeTaluk, Pallakapalayam,  Namakkal District-637303.",CE,CIVIL  ENGINEERING,35,36,1
2634,"Excel Engineering College (Autonomous), NH-47Salem Main Road, Sankari West Post, TiruchengodeTaluk, Pallakapalayam,  Namakkal District-637303.",CJ,M.Tech. Computer Science andEngineering (Integrated 5years),45,36,-9
2634,"Excel Engineering College (Autonomous), NH-47Salem Main Road, Sankari West Post, TiruchengodeTaluk, Pallakapalayam,  Namakkal District-637303.",CS,COMPUTER SCIENCE ANDENGINEERING,106,151,45
2634,"Excel Engineering College (Autonomous), NH-47Salem Main Road, Sankari West Post, TiruchengodeTaluk, Pallakapalayam,  Namakkal District-637303.",EC,ELECTRONICS ANDCOMMUNICATIONENGINEERING,80,70,-10
2634,"Excel Engineering College (Autonomous), NH-47Salem Main Road, Sankari West Post, TiruchengodeTaluk, Pallakapalayam,  Namakkal District-637303.",EE,ELECTRICAL AND ELECTRONICSENGINEERING,44,70,26
2634,"Excel Engineering College (Autonomous), NH-47Salem Main Road, Sankari West Post, TiruchengodeTaluk, Pallakapalayam,  Namakkal District-637303.",FD,FOOD TECHNOLOGY,34,35,1
2634,"Excel Engineering College (Autonomous), NH-47Salem Main Road, Sankari West Post, TiruchengodeTaluk, Pallakapalayam,  Namakkal District-637303.",IT,INFORMATION TECHNOLOGY,116,149,33
2634,"Excel Engineering College (Autonomous), NH-47Salem Main Road, Sankari West Post, TiruchengodeTaluk, Pallakapalayam,  Namakkal District-637303.",ME,MECHANICAL ENGINEERING,35,36,1
2634,"Excel Engineering College (Autonomous), NH-47Salem Main Road, Sankari West Post, TiruchengodeTaluk, Pallakapalayam,  Namakkal District-637303.",PC,PETRO CHEMICALTECHNOLOGY,35,36,1
2634,"Excel Engineering College (Autonomous), NH-47Salem Main Road, Sankari West Post, TiruchengodeTaluk, Pallakapalayam,  Namakkal District-637303.",SF,Safety and Fire Engineering,19,35,16
2635,"CMS College of Engineering, CMS Nagar, EranapuramPost, Namakkal-637003.",AD,Artificial Intelligence and DataScience,35,70,35
2635,"CMS College of Engineering, CMS Nagar, EranapuramPost, Namakkal-637003.",BM,BIO MEDICAL ENGINEERING,35,35,0
2635,"CMS College of Engineering, CMS Nagar, EranapuramPost, Namakkal-637003.",CS,COMPUTER SCIENCE ANDENGINEERING,34,70,36
2635,"CMS College of Engineering, CMS Nagar, EranapuramPost, Namakkal-637003.",EC,ELECTRONICS ANDCOMMUNICATIONENGINEERING,18,18,0
2635,"CMS College of Engineering, CMS Nagar, EranapuramPost, Namakkal-637003.",EE,ELECTRICAL AND ELECTRONICSENGINEERING,17,18,1
2635,"CMS College of Engineering, CMS Nagar, EranapuramPost, Namakkal-637003.",ME,MECHANICAL ENGINEERING,18,19,1
2635,"CMS College of Engineering, CMS Nagar, EranapuramPost, Namakkal-637003.",SC,Computer Science andEngineering (Cyber Security),0,35,35
2636,"AVS Engineering College, Military Road, Ammapet,Salem-636003.",AD,Artificial Intelligence and DataScience,35,150,115
2636,"AVS Engineering College, Military Road, Ammapet,Salem-636003.",BM,BIO MEDICAL ENGINEERING,24,25,1
2636,"AVS Engineering College, Military Road, Ammapet,Salem-636003.",CE,CIVIL  ENGINEERING,27,28,1
2636,"AVS Engineering College, Military Road, Ammapet,Salem-636003.",CS,COMPUTER SCIENCE ANDENGINEERING,70,150,80
2636,"AVS Engineering College, Military Road, Ammapet,Salem-636003.",EC,ELECTRONICS ANDCOMMUNICATIONENGINEERING,100,106,6
2636,"AVS Engineering College, Military Road, Ammapet,Salem-636003.",EE,ELECTRICAL AND ELECTRONICSENGINEERING,52,52,0
2636,"AVS Engineering College, Military Road, Ammapet,Salem-636003.",IT,INFORMATION TECHNOLOGY,44,48,4
2636,"AVS Engineering College, Military Road, Ammapet,Salem-636003.",ME,MECHANICAL ENGINEERING,54,51,-3
2638,"Mahendra Engineering College for Women,Komaramanagalam Post,TiruchengodeTaluk,Namakkal District-637205.",CS,COMPUTER SCIENCE ANDENGINEERING,107,105,-2
2638,Mahendra Engineering College for WomenKumaramangalam  Namakkal District 637205,EC,ELECTRONICS ANDCOMMUNICATIONENGINEERING,70,0,-70
2638,"Mahendra Engineering College for Women,Komaramanagalam Post,TiruchengodeTaluk,Namakkal District-637205.",EE,ELECTRICAL AND ELECTRONICSENGINEERING,0,36,36
2638,"Mahendra Engineering College for Women,Komaramanagalam Post,TiruchengodeTaluk,Namakkal District-637205.",IT,INFORMATION TECHNOLOGY,34,71,37
2639,"R P Sarathy Institute of Technology ,Poosaripatty(PO), Omalur Taluk, Salem-636305.",AD,Artificial Intelligence and DataScience,35,55,20
2639,"R P Sarathy Institute of Technology ,Poosaripatty(PO), Omalur Taluk, Salem-636305.",CS,COMPUTER SCIENCE ANDENGINEERING,70,108,38
2639,"R P Sarathy Institute of Technology ,Poosaripatty(PO), Omalur Taluk, Salem-636305.",EC,ELECTRONICS ANDCOMMUNICATIONENGINEERING,35,108,73
2639,"R P Sarathy Institute of Technology ,Poosaripatty(PO), Omalur Taluk, Salem-636305.",EE,ELECTRICAL AND ELECTRONICSENGINEERING,28,55,27
2639,"R P Sarathy Institute of Technology ,Poosaripatty(PO), Omalur Taluk, Salem-636305.",IT,INFORMATION TECHNOLOGY,35,55,20
2639,"R P Sarathy Institute of Technology ,Poosaripatty(PO), Omalur Taluk, Salem-636305.",ME,MECHANICAL ENGINEERING,27,28,1
2639,"R P Sarathy Institute of Technology ,Poosaripatty(PO), Omalur Taluk, Salem-636305.",SC,Computer Science andEngineering (Cyber Security),0,54,54
2640,"Jayalakshmi Institute of Technology, Thoppur,Dharmapuri District-636352.",AD,Artificial Intelligence and DataScience,54,54,0
2640,"Jayalakshmi Institute of Technology, Thoppur,Dharmapuri District-636352.",AG,AGRICULTURE ENGINEERING,54,28,-26
2640,"Jayalakshmi Institute of Technology, Thoppur,Dharmapuri District-636352.",CE,CIVIL  ENGINEERING,27,27,0
2640,"Jayalakshmi Institute of Technology, Thoppur,Dharmapuri District-636352.",CS,COMPUTER SCIENCE ANDENGINEERING,108,109,1
2640,"Jayalakshmi Institute of Technology, Thoppur,Dharmapuri District-636352.",EC,ELECTRONICS ANDCOMMUNICATIONENGINEERING,55,54,-1
2640,"Jayalakshmi Institute of Technology, Thoppur,Dharmapuri District-636352.",EE,ELECTRICAL AND ELECTRONICSENGINEERING,55,54,-1
2640,"Jayalakshmi Institute of Technology, Thoppur,Dharmapuri District-636352.",IT,INFORMATION TECHNOLOGY,27,28,1
2640,"Jayalakshmi Institute of Technology, Thoppur,Dharmapuri District-636352.",ME,MECHANICAL ENGINEERING,54,54,0
2641,"Varuvan Vadivelan Institute of Technology, NH 7,Krishnagiri Main Road, Gundalapatty, Dharmapuri-636703.",AD,Artificial Intelligence and DataScience,27,28,1
2641,"Varuvan Vadivelan Institute of Technology, NH 7,Krishnagiri Main Road, Gundalapatty, Dharmapuri-636703.",CE,CIVIL  ENGINEERING,27,26,-1
2641,"Varuvan Vadivelan Institute of Technology, NH 7,Krishnagiri Main Road, Gundalapatty, Dharmapuri-636703.",CS,COMPUTER SCIENCE ANDENGINEERING,78,83,5
2641,"Varuvan Vadivelan Institute of Technology, NH 7,Krishnagiri Main Road, Gundalapatty, Dharmapuri-636703.",EC,ELECTRONICS ANDCOMMUNICATIONENGINEERING,51,54,3
2641,"Varuvan Vadivelan Institute of Technology, NH 7,Krishnagiri Main Road, Gundalapatty, Dharmapuri-636703.",EE,ELECTRICAL AND ELECTRONICSENGINEERING,28,27,-1
2641,"Varuvan Vadivelan Institute of Technology, NH 7,Krishnagiri Main Road, Gundalapatty, Dharmapuri-636703.",IT,INFORMATION TECHNOLOGY,78,82,4
2641,"Varuvan Vadivelan Institute of Technology, NH 7,Krishnagiri Main Road, Gundalapatty, Dharmapuri-636703.",ME,MECHANICAL ENGINEERING,28,27,-1
2642,"P.S.V.College of Engineering and Technology,Mittapalli, Balinayanapalli Post, Krishnagiri-635108.",AD,Artificial Intelligence and DataScience,50,36,-14
2642,"P.S.V.College of Engineering and Technology,Mittapalli, Balinayanapalli Post, Krishnagiri-635108.",BM,BIO MEDICAL ENGINEERING,27,28,1
2642,"P.S.V.College of Engineering and Technology,Mittapalli, Balinayanapalli Post, Krishnagiri-635108.",CE,CIVIL  ENGINEERING,27,26,-1
2642,"P.S.V.College of Engineering and Technology,Mittapalli, Balinayanapalli Post, Krishnagiri-635108.",CS,COMPUTER SCIENCE ANDENGINEERING,64,90,26
2642,"P.S.V.College of Engineering and Technology,Mittapalli, Balinayanapalli Post, Krishnagiri-635108.",EC,ELECTRONICS ANDCOMMUNICATIONENGINEERING,49,45,-4
2642,"P.S.V.College of Engineering and Technology,Mittapalli, Balinayanapalli Post, Krishnagiri-635108.",EE,ELECTRICAL AND ELECTRONICSENGINEERING,54,54,0
2642,"P.S.V.College of Engineering and Technology,Mittapalli, Balinayanapalli Post, Krishnagiri-635108.",IT,INFORMATION TECHNOLOGY,68,91,23
2642,"P.S.V.College of Engineering and Technology,Mittapalli, Balinayanapalli Post, Krishnagiri-635108.",ME,MECHANICAL ENGINEERING,55,54,-1
2642,"P.S.V.College of Engineering and Technology,Mittapalli, Balinayanapalli Post, Krishnagiri-635108.",SC,Computer Science andEngineering (Cyber Security),0,55,55
2643,"Bharathiyar Institute of Engineering for Women,43/3, Deviyakurichi, Attur Taluk,Salem District-636112.",AD,Artificial Intelligence and DataScience,103,109,6
2643,"Bharathiyar Institute of Engineering for Women,43/3, Deviyakurichi, Attur Taluk,Salem District-636112.",CS,COMPUTER SCIENCE ANDENGINEERING,104,104,0
2643,"Bharathiyar Institute of Engineering for Women,43/3, Deviyakurichi, Attur Taluk,Salem District-636112.",EC,ELECTRONICS ANDCOMMUNICATIONENGINEERING,54,55,1
2643,"Bharathiyar Institute of Engineering for Women,43/3, Deviyakurichi, Attur Taluk,Salem District-636112.",EE,ELECTRICAL AND ELECTRONICSENGINEERING,55,54,-1
2643,"Bharathiyar Institute of Engineering for Women,43/3, Deviyakurichi, Attur Taluk,Salem District-636112.",SC,Computer Science andEngineering (Cyber Security),0,54,54
2646,"Tagore Institute of Engineering and Technology,Salem-Chennai Bye Pass Road, Deviyakurichi (Po),Attur (Tk), Salem (Dt)-636112.",AD,Artificial Intelligence and DataScience,49,51,2
2646,"Tagore Institute of Engineering and Technology,Salem-Chennai Bye Pass Road, Deviyakurichi (Po),Attur (Tk), Salem (Dt)-636112.",AM,COMPUTER SCIENCE ANDENGINEERING (AI ANDMACHINE LEARNING),23,26,3
2646,"Tagore Institute of Engineering and Technology,Salem-Chennai Bye Pass Road, Deviyakurichi (Po),Attur (Tk), Salem (Dt)-636112.",CE,CIVIL  ENGINEERING,26,27,1
2646,"Tagore Institute of Engineering and Technology,Salem-Chennai Bye Pass Road, Deviyakurichi (Po),Attur (Tk), Salem (Dt)-636112.",CS,COMPUTER SCIENCE ANDENGINEERING,48,51,3
2646,"Tagore Institute of Engineering and Technology,Salem-Chennai Bye Pass Road, Deviyakurichi (Po),Attur (Tk), Salem (Dt)-636112.",EC,ELECTRONICS ANDCOMMUNICATIONENGINEERING,49,54,5
2646,"Tagore Institute of Engineering and Technology,Salem-Chennai Bye Pass Road, Deviyakurichi (Po),Attur (Tk), Salem (Dt)-636112.",EE,ELECTRICAL AND ELECTRONICSENGINEERING,49,53,4
2646,"Tagore Institute of Engineering and Technology,Salem-Chennai Bye Pass Road, Deviyakurichi (Po),Attur (Tk), Salem (Dt)-636112.",ME,MECHANICAL ENGINEERING,49,53,4
2647,"J.K.K.Nataraja College of Engineering and Technology,Sf No. 147/1,2,4 Komarapalayam Amani,Thattankuttai Panchayat, Tiruchengode, Namakkal-638183.",CS,COMPUTER SCIENCE ANDENGINEERING,50,50,0
2647,"J.K.K.Nataraja College of Engineering and Technology,Sf No. 147/1,2,4 Komarapalayam Amani,Thattankuttai Panchayat, Tiruchengode, Namakkal-638183.",EC,ELECTRONICS ANDCOMMUNICATIONENGINEERING,55,55,0
2647,"J.K.K.Nataraja College of Engineering and Technology,Sf No. 147/1,2,4 Komarapalayam Amani,Thattankuttai Panchayat, Tiruchengode, Namakkal-638183.",EE,ELECTRICAL AND ELECTRONICSENGINEERING,54,54,0
2647,"J.K.K.Nataraja College of Engineering and Technology,Sf No. 147/1,2,4 Komarapalayam Amani,Thattankuttai Panchayat, Tiruchengode, Namakkal-638183.",IT,INFORMATION TECHNOLOGY,54,50,-4
2647,"J.K.K.Nataraja College of Engineering and Technology,Sf No. 147/1,2,4 Komarapalayam Amani,Thattankuttai Panchayat, Tiruchengode, Namakkal-638183.",ME,MECHANICAL ENGINEERING,53,54,1
2648,"Annapoorana Engineering College (Autonomous),Sankari Main Road (NH-47), Periyaseeragapadi, Salem636308.",AD,Artificial Intelligence and DataScience,44,45,1
2648,"Annapoorana Engineering College (Autonomous),Sankari Main Road (NH-47), Periyaseeragapadi, Salem636308.",AU,AUTOMOBILE ENGINEERING,55,54,-1
2648,"Annapoorana Engineering College (Autonomous),Sankari Main Road (NH-47), Periyaseeragapadi, Salem636308.",BM,BIO MEDICAL ENGINEERING,55,45,-10
2648,"Annapoorana Engineering College (Autonomous),Sankari Main Road (NH-47), Periyaseeragapadi, Salem636308.",CE,CIVIL  ENGINEERING,55,54,-1
2648,"Annapoorana Engineering College (Autonomous),Sankari Main Road (NH-47), Periyaseeragapadi, Salem636308.",CS,COMPUTER SCIENCE ANDENGINEERING,45,41,-4
2648,"Annapoorana Engineering College (Autonomous),Sankari Main Road (NH-47), Periyaseeragapadi, Salem636308.",EC,ELECTRONICS ANDCOMMUNICATIONENGINEERING,45,45,0
2648,"Annapoorana Engineering College (Autonomous),Sankari Main Road (NH-47), Periyaseeragapadi, Salem636308.",EE,ELECTRICAL AND ELECTRONICSENGINEERING,54,55,1
2648,"Annapoorana Engineering College (Autonomous),Sankari Main Road (NH-47), Periyaseeragapadi, Salem636308.",IT,INFORMATION TECHNOLOGY,45,46,1
2648,"Annapoorana Engineering College (Autonomous),Sankari Main Road (NH-47), Periyaseeragapadi, Salem636308.",ME,MECHANICAL ENGINEERING,54,54,0
2650,"Christ The King Engineering College, Cecilia Gardens,Chikkarampalayam Village, Karamadai, Coimbatore-641104.",AD,Artificial Intelligence and DataScience,49,74,25
2650,Christ The King Engineering College  Cecilia GardensChikkarampalayam Village  Coimbatore District 641104,CE,CIVIL  ENGINEERING,18,0,-18
2650,"Christ The King Engineering College, Cecilia Gardens,Chikkarampalayam Village, Karamadai, Coimbatore-641104.",CS,COMPUTER SCIENCE ANDENGINEERING,49,49,0
2650,"Christ The King Engineering College, Cecilia Gardens,Chikkarampalayam Village, Karamadai, Coimbatore-641104.",EC,ELECTRONICS ANDCOMMUNICATIONENGINEERING,49,49,0
2650,"Christ The King Engineering College, Cecilia Gardens,Chikkarampalayam Village, Karamadai, Coimbatore-641104.",EE,ELECTRICAL AND ELECTRONICSENGINEERING,17,25,8
2650,"Christ The King Engineering College, Cecilia Gardens,Chikkarampalayam Village, Karamadai, Coimbatore-641104.",IT,INFORMATION TECHNOLOGY,48,49,1
2650,"Christ The King Engineering College, Cecilia Gardens,Chikkarampalayam Village, Karamadai, Coimbatore-641104.",ME,MECHANICAL ENGINEERING,35,49,14
2651,"Jai Shriram Engineering College , Dharapuram Road,Tirupur-638660.",AD,Artificial Intelligence and DataScience,40,41,1
2651,"Jai Shriram Engineering College , Dharapuram Road,Tirupur-638660.",CE,CIVIL  ENGINEERING,18,18,0
2651,"Jai Shriram Engineering College , Dharapuram Road,Tirupur-638660.",CS,COMPUTER SCIENCE ANDENGINEERING,64,65,1
2651,"Jai Shriram Engineering College , Dharapuram Road,Tirupur-638660.",EC,ELECTRONICS ANDCOMMUNICATIONENGINEERING,45,49,4
2651,"Jai Shriram Engineering College , Dharapuram Road,Tirupur-638660.",EE,ELECTRICAL AND ELECTRONICSENGINEERING,44,41,-3
2651,"Jai Shriram Engineering College , Dharapuram Road,Tirupur-638660.",FT,FASHION TECHNOLOGY,44,45,1
2651,"Jai Shriram Engineering College , Dharapuram Road,Tirupur-638660.",IT,INFORMATION TECHNOLOGY,0,45,45
2651,"Jai Shriram Engineering College , Dharapuram Road,Tirupur-638660.",ME,MECHANICAL ENGINEERING,35,41,6
2652,"AL-Ameen Engineering College (Autonomous),Karundevanpalayam, Nanjai Uthukkuli Post, ErodeDistrict-638104.",AD,Artificial Intelligence and DataScience,27,27,0
2652,"AL-Ameen Engineering College (Autonomous),Karundevanpalayam, Nanjai Uthukkuli Post, ErodeDistrict-638104.",CS,COMPUTER SCIENCE ANDENGINEERING,54,55,1
2652,"AL-Ameen Engineering College (Autonomous),Karundevanpalayam, Nanjai Uthukkuli Post, ErodeDistrict-638104.",EC,ELECTRONICS ANDCOMMUNICATIONENGINEERING,26,28,2
2652,"AL-Ameen Engineering College (Autonomous),Karundevanpalayam, Nanjai Uthukkuli Post, ErodeDistrict-638104.",EE,ELECTRICAL AND ELECTRONICSENGINEERING,28,26,-2
2652,"AL-Ameen Engineering College (Autonomous),Karundevanpalayam, Nanjai Uthukkuli Post, ErodeDistrict-638104.",IT,INFORMATION TECHNOLOGY,27,28,1
2652,"AL-Ameen Engineering College (Autonomous),Karundevanpalayam, Nanjai Uthukkuli Post, ErodeDistrict-638104.",ME,MECHANICAL ENGINEERING,54,53,-1
2653,"Knowledge Institute of Technology (Autonomous),KIOT Campus, Kakapalayam (PO), Salem-637504.",AD,Artificial Intelligence and DataScience,34,90,56
2653,"Knowledge Institute of Technology (Autonomous),KIOT Campus, Kakapalayam (PO), Salem-637504.",CB,COMPUTER SCIENCE ANDBUSSINESS SYSTEM,35,36,1
2653,"Knowledge Institute of Technology (Autonomous),KIOT Campus, Kakapalayam (PO), Salem-637504.",CE,CIVIL  ENGINEERING,18,19,1
2653,"Knowledge Institute of Technology (Autonomous),KIOT Campus, Kakapalayam (PO), Salem-637504.",CS,COMPUTER SCIENCE ANDENGINEERING,106,146,40
2653,"Knowledge Institute of Technology (Autonomous),KIOT Campus, Kakapalayam (PO), Salem-637504.",EC,ELECTRONICS ANDCOMMUNICATIONENGINEERING,71,114,43
2653,"Knowledge Institute of Technology (Autonomous),KIOT Campus, Kakapalayam (PO), Salem-637504.",EE,ELECTRICAL AND ELECTRONICSENGINEERING,35,36,1
2653,"Knowledge Institute of Technology (Autonomous),KIOT Campus, Kakapalayam (PO), Salem-637504.",IT,INFORMATION TECHNOLOGY,34,89,55
2653,"Knowledge Institute of Technology (Autonomous),KIOT Campus, Kakapalayam (PO), Salem-637504.",ME,MECHANICAL ENGINEERING,70,70,0
2656,"Builders Engineering College (Autonomous), EBETKnowledge Park, Erode Road Nathakadaiyur,Kangeyam, Tiruppur-638108.",AD,Artificial Intelligence and DataScience,34,35,1
2656,"Builders Engineering College (Autonomous), EBETKnowledge Park, Erode Road Nathakadaiyur,Kangeyam, Tiruppur-638108.",AM,COMPUTER SCIENCE ANDENGINEERING (AI ANDMACHINE LEARNING),0,35,35
2656,"Builders Engineering College (Autonomous), EBETKnowledge Park, Erode Road Nathakadaiyur,Kangeyam, Tiruppur-638108.",CE,CIVIL  ENGINEERING,45,35,-10
2656,"Builders Engineering College (Autonomous), EBETKnowledge Park, Erode Road Nathakadaiyur,Kangeyam, Tiruppur-638108.",CS,COMPUTER SCIENCE ANDENGINEERING,35,36,1
2656,"Builders Engineering College (Autonomous), EBETKnowledge Park, Erode Road Nathakadaiyur,Kangeyam, Tiruppur-638108.",EC,ELECTRONICS ANDCOMMUNICATIONENGINEERING,36,36,0
2656,"Builders Engineering College (Autonomous), EBETKnowledge Park, Erode Road Nathakadaiyur,Kangeyam, Tiruppur-638108.",EE,ELECTRICAL AND ELECTRONICSENGINEERING,45,35,-10
2656,"Builders Engineering College (Autonomous), EBETKnowledge Park, Erode Road Nathakadaiyur,Kangeyam, Tiruppur-638108.",ME,MECHANICAL ENGINEERING,46,36,-10
2658,"V S A Group of Institutions, NH-47 Main Road,Uthamasolapuram Post, Salem-636010.",BM,BIO MEDICAL ENGINEERING,48,43,-5
2658,"V S A Group of Institutions, NH-47 Main Road,Uthamasolapuram Post, Salem-636010.",CE,CIVIL  ENGINEERING,22,23,1
2658,"V S A Group of Institutions, NH-47 Main Road,Uthamasolapuram Post, Salem-636010.",CS,COMPUTER SCIENCE ANDENGINEERING,46,41,-5
2658,"V S A Group of Institutions, NH-47 Main Road,Uthamasolapuram Post, Salem-636010.",EC,ELECTRONICS ANDCOMMUNICATIONENGINEERING,49,41,-8
2658,"V S A Group of Institutions, NH-47 Main Road,Uthamasolapuram Post, Salem-636010.",EE,ELECTRICAL AND ELECTRONICSENGINEERING,24,22,-2
2658,"V S A Group of Institutions, NH-47 Main Road,Uthamasolapuram Post, Salem-636010.",IT,INFORMATION TECHNOLOGY,49,35,-14
2658,"V S A Group of Institutions, NH-47 Main Road,Uthamasolapuram Post, Salem-636010.",ME,MECHANICAL ENGINEERING,49,49,0
2659,"Salem College of Engineering and Technology, NH-68Salem-Attur Main Road, Mettupatty Perumapalayam,Salem-636111.",AD,Artificial Intelligence and DataScience,24,18,-6
2659,"Salem College of Engineering and Technology, NH-68Salem-Attur Main Road, Mettupatty Perumapalayam,Salem-636111.",BM,BIO MEDICAL ENGINEERING,41,41,0
2659,"Salem College of Engineering and Technology, NH-68Salem-Attur Main Road, Mettupatty Perumapalayam,Salem-636111.",BT,BIO TECHNOLOGY,17,17,0
2659,"Salem College of Engineering and Technology, NH-68Salem-Attur Main Road, Mettupatty Perumapalayam,Salem-636111.",CE,CIVIL  ENGINEERING,18,19,1
2659,"Salem College of Engineering and Technology, NH-68Salem-Attur Main Road, Mettupatty Perumapalayam,Salem-636111.",CS,COMPUTER SCIENCE ANDENGINEERING,46,49,3
2659,"Salem College of Engineering and Technology, NH-68Salem-Attur Main Road, Mettupatty Perumapalayam,Salem-636111.",EC,ELECTRONICS ANDCOMMUNICATIONENGINEERING,54,40,-14
2659,"Salem College of Engineering and Technology, NH-68Salem-Attur Main Road, Mettupatty Perumapalayam,Salem-636111.",EE,ELECTRICAL AND ELECTRONICSENGINEERING,25,21,-4
2659,"Salem College of Engineering and Technology, NH-68Salem-Attur Main Road, Mettupatty Perumapalayam,Salem-636111.",IT,INFORMATION TECHNOLOGY,49,49,0
2659,"Salem College of Engineering and Technology, NH-68Salem-Attur Main Road, Mettupatty Perumapalayam,Salem-636111.",ME,MECHANICAL ENGINEERING,41,35,-6
2661,Vivekanandha College of Technology for WomenSathinaickenpalayam  Elayampalayam VillageKumaramangalam  Namakkal District 637205,AD,ARTIFICIAL INTELLIGENCEAND DATA SCIENCE,35,0,-35
2661,Vivekanandha College of Technology for WomenSathinaickenpalayam  Elayampalayam VillageKumaramangalam  Namakkal District 637205,AG,AGRICULTURAL ENGINEERING,22,0,-22
2661,Vivekanandha College of Technology for WomenSathinaickenpalayam  Elayampalayam VillageKumaramangalam  Namakkal District 637205,CE,CIVIL  ENGINEERING,27,0,-27
2661,Vivekanandha College of Technology for WomenSathinaickenpalayam  Elayampalayam VillageKumaramangalam  Namakkal District 637205,CS,COMPUTER SCIENCE ANDENGINEERING,71,0,-71
2661,Vivekanandha College of Technology for WomenSathinaickenpalayam  Elayampalayam VillageKumaramangalam  Namakkal District 637205,EC,ELECTRONICS ANDCOMMUNICATIONENGINEERING,35,0,-35
2661,Vivekanandha College of Technology for WomenSathinaickenpalayam  Elayampalayam VillageKumaramangalam  Namakkal District 637205,IT,INFORMATION TECHNOLOGY,35,0,-35
2673,"Sree Sakthi Engineering College (Autonomous), 899/1& 898/2, Bettathapuram, Bilichi Village, Karamadai,Coimbatore-641104.",AD,Artificial Intelligence and DataScience,0,41,41
2673,"Sree Sakthi Engineering College (Autonomous), 899/1& 898/2, Bettathapuram, Bilichi Village, Karamadai,Coimbatore-641104.",AM,COMPUTER SCIENCE ANDENGINEERING (AI ANDMACHINE LEARNING),27,41,14
2673,"Sree Sakthi Engineering College (Autonomous), 899/1& 898/2, Bettathapuram, Bilichi Village, Karamadai,Coimbatore-641104.",CE,CIVIL  ENGINEERING,18,20,2
2673,"Sree Sakthi Engineering College (Autonomous), 899/1& 898/2, Bettathapuram, Bilichi Village, Karamadai,Coimbatore-641104.",CS,COMPUTER SCIENCE ANDENGINEERING,54,63,9
2673,"Sree Sakthi Engineering College (Autonomous), 899/1& 898/2, Bettathapuram, Bilichi Village, Karamadai,Coimbatore-641104.",EC,ELECTRONICS ANDCOMMUNICATIONENGINEERING,53,63,10
2673,"Sree Sakthi Engineering College (Autonomous), 899/1& 898/2, Bettathapuram, Bilichi Village, Karamadai,Coimbatore-641104.",EE,ELECTRICAL AND ELECTRONICSENGINEERING,27,41,14
2673,"Sree Sakthi Engineering College (Autonomous), 899/1& 898/2, Bettathapuram, Bilichi Village, Karamadai,Coimbatore-641104.",IT,INFORMATION TECHNOLOGY,55,41,-14
2673,"Sree Sakthi Engineering College (Autonomous), 899/1& 898/2, Bettathapuram, Bilichi Village, Karamadai,Coimbatore-641104.",ME,MECHANICAL ENGINEERING,35,41,6
2673,"Sree Sakthi Engineering College (Autonomous), 899/1& 898/2, Bettathapuram, Bilichi Village, Karamadai,Coimbatore-641104.",SC,Computer Science andEngineering (Cyber Security),27,40,13
2683,"Shreenivasa Engineering College, B.Pallipatti,Bommidi, Pappireddipatti Taluk, Dharmapuri District-635301.",AD,Artificial Intelligence and DataScience,35,49,14
2683,"Shreenivasa Engineering College, B.Pallipatti,Bommidi, Pappireddipatti Taluk, Dharmapuri District-635301.",AG,AGRICULTURE ENGINEERING,35,35,0
2683,"Shreenivasa Engineering College, B.Pallipatti,Bommidi, Pappireddipatti Taluk, Dharmapuri District-635301.",BM,BIO MEDICAL ENGINEERING,34,41,7
2683,"Shreenivasa Engineering College, B.Pallipatti,Bommidi, Pappireddipatti Taluk, Dharmapuri District-635301.",CS,COMPUTER SCIENCE ANDENGINEERING,35,49,14
2683,"Shreenivasa Engineering College, B.Pallipatti,Bommidi, Pappireddipatti Taluk, Dharmapuri District-635301.",EE,ELECTRICAL AND ELECTRONICSENGINEERING,18,19,1
2683,"Shreenivasa Engineering College, B.Pallipatti,Bommidi, Pappireddipatti Taluk, Dharmapuri District-635301.",IT,INFORMATION TECHNOLOGY,45,43,-2
2683,"Shreenivasa Engineering College, B.Pallipatti,Bommidi, Pappireddipatti Taluk, Dharmapuri District-635301.",ME,MECHANICAL ENGINEERING,18,17,-1
2702,"Bannari Amman Institute of Technology(Autonomous), Sathy-Bhavani Road, (State Highway),Alathukombai Post, Sathyamangalam (Taluk), ErodeDistrict-638401.",AD,Artificial Intelligence and DataScience,102,140,38
2702,"Bannari Amman Institute of Technology(Autonomous), Sathy-Bhavani Road, (State Highway),Alathukombai Post, Sathyamangalam (Taluk), ErodeDistrict-638401.",AG,AGRICULTURE ENGINEERING,35,19,-16
2702,"Bannari Amman Institute of Technology(Autonomous), Sathy-Bhavani Road, (State Highway),Alathukombai Post, Sathyamangalam (Taluk), ErodeDistrict-638401.",AL,Artificial Intelligence andMachine Learning,70,71,1
2702,Bannari Amman Institute of Technology (Autonomous)Sathyamanagalam  Erode District  638401,BM,BIO MEDICAL ENGINEERING,40,0,-40
2702,"Bannari Amman Institute of Technology(Autonomous), Sathy-Bhavani Road, (State Highway),Alathukombai Post, Sathyamangalam (Taluk), ErodeDistrict-638401.",BT,BIO TECHNOLOGY,70,70,0
2702,"Bannari Amman Institute of Technology(Autonomous), Sathy-Bhavani Road, (State Highway),Alathukombai Post, Sathyamangalam (Taluk), ErodeDistrict-638401.",CB,COMPUTER SCIENCE ANDBUSSINESS SYSTEM,35,36,1
2702,Bannari Amman Institute of Technology (Autonomous)Sathyamanagalam  Erode District  638401,CD,COMPUTER SCIENCE ANDDESIGN,40,0,-40
2702,Bannari Amman Institute of Technology (Autonomous)Sathyamanagalam  Erode District  638401,CE,CIVIL  ENGINEERING,20,0,-20
2702,"Bannari Amman Institute of Technology(Autonomous), Sathy-Bhavani Road, (State Highway),Alathukombai Post, Sathyamangalam (Taluk), ErodeDistrict-638401.",CS,COMPUTER SCIENCE ANDENGINEERING,141,213,72
2702,Bannari Amman Institute of Technology (Autonomous)Sathyamanagalam  Erode District  638401,CT,COMPUTER TECHNOLOGY,35,0,-35
2702,"Bannari Amman Institute of Technology(Autonomous), Sathy-Bhavani Road, (State Highway),Alathukombai Post, Sathyamangalam (Taluk), ErodeDistrict-638401.",EC,ELECTRONICS ANDCOMMUNICATIONENGINEERING,168,141,-27
2702,"Bannari Amman Institute of Technology(Autonomous), Sathy-Bhavani Road, (State Highway),Alathukombai Post, Sathyamangalam (Taluk), ErodeDistrict-638401.",EE,ELECTRICAL AND ELECTRONICSENGINEERING,35,82,47
2702,"Bannari Amman Institute of Technology(Autonomous), Sathy-Bhavani Road, (State Highway),Alathukombai Post, Sathyamangalam (Taluk), ErodeDistrict-638401.",EI,ELECTRONICS ANDINSTRUMENTATIONENGINEERING,35,36,1
2702,Bannari Amman Institute of Technology (Autonomous)Sathyamanagalam  Erode District  638401,FD,FOOD TECHNOLOGY,41,0,-41
2702,Bannari Amman Institute of Technology (Autonomous)Sathyamanagalam  Erode District  638401,FT,FASHION TECHNOLOGY,19,0,-19
2702,"Bannari Amman Institute of Technology(Autonomous), Sathy-Bhavani Road, (State Highway),Alathukombai Post, Sathyamangalam (Taluk), ErodeDistrict-638401.",IT,INFORMATION TECHNOLOGY,106,140,34
2702,"Bannari Amman Institute of Technology(Autonomous), Sathy-Bhavani Road, (State Highway),Alathukombai Post, Sathyamangalam (Taluk), ErodeDistrict-638401.",ME,MECHANICAL ENGINEERING,35,36,1
2702,"Bannari Amman Institute of Technology(Autonomous), Sathy-Bhavani Road, (State Highway),Alathukombai Post, Sathyamangalam (Taluk), ErodeDistrict-638401.",MZ,Mechatronics Engineering,37,35,-2
2702,Bannari Amman Institute of Technology (Autonomous)Sathyamanagalam  Erode District  638401,SE,Information Science andEngineering,43,0,-43
2704,"Coimbatore Institute of Engineering and Technology(Autonomous), Vellimalaipattinam, NarasipuramPost, Thondamuthur Via, Coimbatore-641109.",AD,Artificial Intelligence and DataScience,35,80,45
2704,"Coimbatore Institute of Engineering and Technology(Autonomous), Vellimalaipattinam, NarasipuramPost, Thondamuthur Via, Coimbatore-641109.",AM,COMPUTER SCIENCE ANDENGINEERING (AI ANDMACHINE LEARNING),0,45,45
2704,"Coimbatore Institute of Engineering and Technology(Autonomous), Vellimalaipattinam, NarasipuramPost, Thondamuthur Via, Coimbatore-641109.",CE,CIVIL  ENGINEERING,24,23,-1
2704,"Coimbatore Institute of Engineering and Technology(Autonomous), Vellimalaipattinam, NarasipuramPost, Thondamuthur Via, Coimbatore-641109.",CS,COMPUTER SCIENCE ANDENGINEERING,69,76,7
2704,"Coimbatore Institute of Engineering and Technology(Autonomous), Vellimalaipattinam, NarasipuramPost, Thondamuthur Via, Coimbatore-641109.",EC,ELECTRONICS ANDCOMMUNICATIONENGINEERING,34,35,1
2704,"Coimbatore Institute of Engineering and Technology(Autonomous), Vellimalaipattinam, NarasipuramPost, Thondamuthur Via, Coimbatore-641109.",EE,ELECTRICAL AND ELECTRONICSENGINEERING,22,23,1
2704,"Coimbatore Institute of Engineering and Technology(Autonomous), Vellimalaipattinam, NarasipuramPost, Thondamuthur Via, Coimbatore-641109.",EV,Electronics Engineering (VLSIDesign and Technology),0,49,49
2704,"Coimbatore Institute of Engineering and Technology(Autonomous), Vellimalaipattinam, NarasipuramPost, Thondamuthur Via, Coimbatore-641109.",IT,INFORMATION TECHNOLOGY,36,39,3
2704,"Coimbatore Institute of Engineering and Technology(Autonomous), Vellimalaipattinam, NarasipuramPost, Thondamuthur Via, Coimbatore-641109.",ME,MECHANICAL ENGINEERING,46,49,3
2704,"Coimbatore Institute of Engineering and Technology(Autonomous), Vellimalaipattinam, NarasipuramPost, Thondamuthur Via, Coimbatore-641109.",MZ,Mechatronics Engineering,19,40,21
2704,"Coimbatore Institute of Engineering and Technology(Autonomous), Vellimalaipattinam, NarasipuramPost, Thondamuthur Via, Coimbatore-641109.",SC,Computer Science andEngineering (Cyber Security),18,45,27
2705,"CSI College of Engineering, Ketti Valley, The Nilgiris-643215.",AD,Artificial Intelligence and DataScience,27,36,9
2705,"CSI College of Engineering, Ketti Valley, The Nilgiris-643215.",AM,COMPUTER SCIENCE ANDENGINEERING (AI ANDMACHINE LEARNING),0,36,36
2705,"CSI College of Engineering, Ketti Valley, The Nilgiris-643215.",CE,CIVIL  ENGINEERING,13,19,6
2705,"CSI College of Engineering, Ketti Valley, The Nilgiris-643215.",CS,COMPUTER SCIENCE ANDENGINEERING,53,81,28
2705,"CSI College of Engineering, Ketti Valley, The Nilgiris-643215.",EC,ELECTRONICS ANDCOMMUNICATIONENGINEERING,28,36,8
2705,"CSI College of Engineering, Ketti Valley, The Nilgiris-643215.",EE,ELECTRICAL AND ELECTRONICSENGINEERING,27,36,9
2705,"CSI College of Engineering, Ketti Valley, The Nilgiris-643215.",IT,INFORMATION TECHNOLOGY,27,36,9
2705,"CSI College of Engineering, Ketti Valley, The Nilgiris-643215.",ME,MECHANICAL ENGINEERING,27,36,9
2705,"CSI College of Engineering, Ketti Valley, The Nilgiris-643215.",SC,Computer Science andEngineering (Cyber Security),0,37,37
2706,"Dr Mahalingam College of Engineering andTechnology (Autonomous), Mackkinaickenpatti Post,Udumalai Road, Pollachi, Coimbatore-642003.",AD,Artificial Intelligence and DataScience,70,80,10
2706,"Dr Mahalingam College of Engineering andTechnology (Autonomous), Mackkinaickenpatti Post,Udumalai Road, Pollachi, Coimbatore-642003.",AM,COMPUTER SCIENCE ANDENGINEERING (AI ANDMACHINE LEARNING),35,36,1
2706,"Dr Mahalingam College of Engineering andTechnology (Autonomous), Mackkinaickenpatti Post,Udumalai Road, Pollachi, Coimbatore-642003.",AU,AUTOMOBILE ENGINEERING,39,44,5
2706,"Dr Mahalingam College of Engineering andTechnology (Autonomous), Mackkinaickenpatti Post,Udumalai Road, Pollachi, Coimbatore-642003.",CE,CIVIL  ENGINEERING,45,51,6
2706,"Dr Mahalingam College of Engineering andTechnology (Autonomous), Mackkinaickenpatti Post,Udumalai Road, Pollachi, Coimbatore-642003.",CS,COMPUTER SCIENCE ANDENGINEERING,106,111,5
2706,"Dr Mahalingam College of Engineering andTechnology (Autonomous), Mackkinaickenpatti Post,Udumalai Road, Pollachi, Coimbatore-642003.",EA,Electronics and Communication(Advanced CommunicationTechnology),45,54,9
2706,"Dr Mahalingam College of Engineering andTechnology (Autonomous), Mackkinaickenpatti Post,Udumalai Road, Pollachi, Coimbatore-642003.",EC,ELECTRONICS ANDCOMMUNICATIONENGINEERING,71,73,2
2706,"Dr Mahalingam College of Engineering andTechnology (Autonomous), Mackkinaickenpatti Post,Udumalai Road, Pollachi, Coimbatore-642003.",EE,ELECTRICAL AND ELECTRONICSENGINEERING,71,79,8
2706,"Dr Mahalingam College of Engineering andTechnology (Autonomous), Mackkinaickenpatti Post,Udumalai Road, Pollachi, Coimbatore-642003.",EV,Electronics Engineering (VLSIDesign and Technology),45,40,-5
2706,"Dr Mahalingam College of Engineering andTechnology (Autonomous), Mackkinaickenpatti Post,Udumalai Road, Pollachi, Coimbatore-642003.",IT,INFORMATION TECHNOLOGY,72,70,-2
2706,"Dr Mahalingam College of Engineering andTechnology (Autonomous), Mackkinaickenpatti Post,Udumalai Road, Pollachi, Coimbatore-642003.",ME,MECHANICAL ENGINEERING,34,46,12
2706,"Dr Mahalingam College of Engineering andTechnology (Autonomous), Mackkinaickenpatti Post,Udumalai Road, Pollachi, Coimbatore-642003.",SC,Computer Science andEngineering (Cyber Security),35,35,0
2707,"Erode Sengunthar Engineering College (Autonomous),Thudupathi, Perundurai (Tk), Erode District-638057.",AD,Artificial Intelligence and DataScience,70,105,35
2707,"Erode Sengunthar Engineering College (Autonomous),Thudupathi, Perundurai (Tk), Erode District-638057.",AG,AGRICULTURE ENGINEERING,44,54,10
2707,"Erode Sengunthar Engineering College (Autonomous),Thudupathi, Perundurai (Tk), Erode District-638057.",AM,COMPUTER SCIENCE ANDENGINEERING (AI ANDMACHINE LEARNING),0,44,44
2707,"Erode Sengunthar Engineering College (Autonomous),Thudupathi, Perundurai (Tk), Erode District-638057.",BM,BIO MEDICAL ENGINEERING,44,108,64
2707,"Erode Sengunthar Engineering College (Autonomous),Thudupathi, Perundurai (Tk), Erode District-638057.",BT,BIO TECHNOLOGY,45,55,10
2707,"Erode Sengunthar Engineering College (Autonomous),Thudupathi, Perundurai (Tk), Erode District-638057.",CD,COMPUTER SCIENCE ANDDESIGN,41,55,14
2707,"Erode Sengunthar Engineering College (Autonomous),Thudupathi, Perundurai (Tk), Erode District-638057.",CE,CIVIL  ENGINEERING,18,28,10
2707,"Erode Sengunthar Engineering College (Autonomous),Thudupathi, Perundurai (Tk), Erode District-638057.",CH,CHEMICAL  ENGINEERING,67,81,14
2707,"Erode Sengunthar Engineering College (Autonomous),Thudupathi, Perundurai (Tk), Erode District-638057.",CJ,M.Tech. Computer Science andEngineering (Integrated 5years),49,54,5
2707,"Erode Sengunthar Engineering College (Autonomous),Thudupathi, Perundurai (Tk), Erode District-638057.",CS,COMPUTER SCIENCE ANDENGINEERING,70,136,66
2707,"Erode Sengunthar Engineering College (Autonomous),Thudupathi, Perundurai (Tk), Erode District-638057.",EC,ELECTRONICS ANDCOMMUNICATIONENGINEERING,90,108,18
2707,"Erode Sengunthar Engineering College (Autonomous),Thudupathi, Perundurai (Tk), Erode District-638057.",EE,ELECTRICAL AND ELECTRONICSENGINEERING,46,55,9
2707,"Erode Sengunthar Engineering College (Autonomous),Thudupathi, Perundurai (Tk), Erode District-638057.",EI,ELECTRONICS ANDINSTRUMENTATIONENGINEERING,22,28,6
2707,"Erode Sengunthar Engineering College (Autonomous),Thudupathi, Perundurai (Tk), Erode District-638057.",IT,INFORMATION TECHNOLOGY,89,91,2
2707,"Erode Sengunthar Engineering College (Autonomous),Thudupathi, Perundurai (Tk), Erode District-638057.",ME,MECHANICAL ENGINEERING,49,54,5
2707,"Erode Sengunthar Engineering College (Autonomous),Thudupathi, Perundurai (Tk), Erode District-638057.",RM,ROBOTICS AND AUTOMATION,23,26,3
2707,"Erode Sengunthar Engineering College (Autonomous),Thudupathi, Perundurai (Tk), Erode District-638057.",SC,Computer Science andEngineering (Cyber Security),0,50,50
2707,"Erode Sengunthar Engineering College (Autonomous),Thudupathi, Perundurai (Tk), Erode District-638057.",XM,MECHANICAL ENGINEERING(TAMIL MEDIUM),40,55,15
2708,"Hindusthan College of Engineering andTechnology(Autonomous), OthakkalmandapamVillage, Coimbatore South Taluk, Coimbatore District-641032.",AE,AERONAUTICAL ENGINEERING,34,36,2
2708,"Hindusthan College of Engineering andTechnology(Autonomous), OthakkalmandapamVillage, Coimbatore South Taluk, Coimbatore District-641032.",AG,AGRICULTURE ENGINEERING,35,35,0
2708,"Hindusthan College of Engineering andTechnology(Autonomous), OthakkalmandapamVillage, Coimbatore South Taluk, Coimbatore District-641032.",AL,Artificial Intelligence andMachine Learning,35,36,1
2708,"Hindusthan College of Engineering andTechnology(Autonomous), OthakkalmandapamVillage, Coimbatore South Taluk, Coimbatore District-641032.",AU,AUTOMOBILE ENGINEERING,35,36,1
2708,"Hindusthan College of Engineering andTechnology(Autonomous), OthakkalmandapamVillage, Coimbatore South Taluk, Coimbatore District-641032.",BM,BIO MEDICAL ENGINEERING,35,37,2
2708,"Hindusthan College of Engineering andTechnology(Autonomous), OthakkalmandapamVillage, Coimbatore South Taluk, Coimbatore District-641032.",CE,CIVIL  ENGINEERING,35,35,0
2708,"Hindusthan College of Engineering andTechnology(Autonomous), OthakkalmandapamVillage, Coimbatore South Taluk, Coimbatore District-641032.",CH,CHEMICAL  ENGINEERING,35,35,0
2708,"Hindusthan College of Engineering andTechnology(Autonomous), OthakkalmandapamVillage, Coimbatore South Taluk, Coimbatore District-641032.",CS,COMPUTER SCIENCE ANDENGINEERING,107,106,-1
2708,"Hindusthan College of Engineering andTechnology(Autonomous), OthakkalmandapamVillage, Coimbatore South Taluk, Coimbatore District-641032.",EC,ELECTRONICS ANDCOMMUNICATIONENGINEERING,70,71,1
2708,"Hindusthan College of Engineering andTechnology(Autonomous), OthakkalmandapamVillage, Coimbatore South Taluk, Coimbatore District-641032.",EE,ELECTRICAL AND ELECTRONICSENGINEERING,36,35,-1
2708,"Hindusthan College of Engineering andTechnology(Autonomous), OthakkalmandapamVillage, Coimbatore South Taluk, Coimbatore District-641032.",EI,ELECTRONICS ANDINSTRUMENTATIONENGINEERING,18,16,-2
2708,"Hindusthan College of Engineering andTechnology(Autonomous), OthakkalmandapamVillage, Coimbatore South Taluk, Coimbatore District-641032.",FD,FOOD TECHNOLOGY,36,35,-1
2708,"Hindusthan College of Engineering andTechnology(Autonomous), OthakkalmandapamVillage, Coimbatore South Taluk, Coimbatore District-641032.",IT,INFORMATION TECHNOLOGY,71,70,-1
2708,"Hindusthan College of Engineering andTechnology(Autonomous), OthakkalmandapamVillage, Coimbatore South Taluk, Coimbatore District-641032.",ME,MECHANICAL ENGINEERING,71,70,-1
2708,"Hindusthan College of Engineering andTechnology(Autonomous), OthakkalmandapamVillage, Coimbatore South Taluk, Coimbatore District-641032.",MZ,Mechatronics Engineering,70,70,0
2708,"Hindusthan College of Engineering andTechnology(Autonomous), OthakkalmandapamVillage, Coimbatore South Taluk, Coimbatore District-641032.",SC,Computer Science andEngineering (Cyber Security),0,36,36
2709,Government College of Engineering (FormerlyInstitute of Road and Transport Technology)  VasaviCollege Post  Erode District 638316,AU,AUTOMOBILE ENGINEERING,36,35,-1
2709,Government College of Engineering (FormerlyInstitute of Road and Transport Technology)  VasaviCollege Post  Erode District 638316,CE,CIVIL  ENGINEERING,35,35,0
2709,Government College of Engineering (FormerlyInstitute of Road and Transport Technology)  VasaviCollege Post  Erode District 638316,CS,COMPUTER SCIENCE ANDENGINEERING,33,35,2
2709,Government College of Engineering (FormerlyInstitute of Road and Transport Technology)  VasaviCollege Post  Erode District 638316,EC,ELECTRONICS ANDCOMMUNICATIONENGINEERING,34,35,1
2709,Government College of Engineering (FormerlyInstitute of Road and Transport Technology)  VasaviCollege Post  Erode District 638316,EE,ELECTRICAL AND ELECTRONICSENGINEERING,35,36,1
2709,Government College of Engineering (FormerlyInstitute of Road and Transport Technology)  VasaviCollege Post  Erode District 638316,IT,INFORMATION TECHNOLOGY,35,35,0
2709,Government College of Engineering (FormerlyInstitute of Road and Transport Technology)  VasaviCollege Post  Erode District 638316,ME,MECHANICAL ENGINEERING,35,36,1
2710,"Karpagam College of Engineering (Autonomous),S.F.No.758,759,760 Othakkal Mandapam,Coimbatore -641032.",AD,Artificial Intelligence and DataScience,54,82,28
2710,Karpagam College of Engineering (Autonomous)Othakkalmandapam  Coimbatore District 641032,CD,COMPUTER SCIENCE ANDDESIGN,28,0,-28
2710,"Karpagam College of Engineering (Autonomous),S.F.No.758,759,760 Othakkal Mandapam,Coimbatore -641032.",CE,CIVIL  ENGINEERING,32,33,1
2710,"Karpagam College of Engineering (Autonomous),S.F.No.758,759,760 Othakkal Mandapam,Coimbatore -641032.",CS,COMPUTER SCIENCE ANDENGINEERING,80,81,1
2710,"Karpagam College of Engineering (Autonomous),S.F.No.758,759,760 Othakkal Mandapam,Coimbatore -641032.",EC,ELECTRONICS ANDCOMMUNICATIONENGINEERING,81,81,0
2710,"Karpagam College of Engineering (Autonomous),S.F.No.758,759,760 Othakkal Mandapam,Coimbatore -641032.",EE,ELECTRICAL AND ELECTRONICSENGINEERING,55,55,0
2710,Karpagam College of Engineering (Autonomous)Othakkalmandapam  Coimbatore District 641032,ET,ELECTRONICS ANDTELECOMMUNICATIONENGINEERING,27,0,-27
2710,"Karpagam College of Engineering (Autonomous),S.F.No.758,759,760 Othakkal Mandapam,Coimbatore -641032.",EV,Electronics Engineering (VLSIDesign and Technology),0,27,27
2710,"Karpagam College of Engineering (Autonomous),S.F.No.758,759,760 Othakkal Mandapam,Coimbatore -641032.",IT,INFORMATION TECHNOLOGY,54,81,27
2710,"Karpagam College of Engineering (Autonomous),S.F.No.758,759,760 Othakkal Mandapam,Coimbatore -641032.",ME,MECHANICAL ENGINEERING,55,55,0
2710,"Karpagam College of Engineering (Autonomous),S.F.No.758,759,760 Othakkal Mandapam,Coimbatore -641032.",SC,Computer Science andEngineering (Cyber Security),28,27,-1
2710,Karpagam College of Engineering (Autonomous)Othakkalmandapam  Coimbatore District 641032,TS,Computer Science andTechnology,27,0,-27
2711,"Kongu Engineering College (Autonomous), PerunduraiRailway Station Road,Thoppupalayam,Perundurai,Erode-638052.",AD,Artificial Intelligence and DataScience,105,105,0
2711,"Kongu Engineering College (Autonomous), PerunduraiRailway Station Road,Thoppupalayam,Perundurai,Erode-638052.",AL,Artificial Intelligence andMachine Learning,71,36,-35
2711,"Kongu Engineering College (Autonomous), PerunduraiRailway Station Road,Thoppupalayam,Perundurai,Erode-638052.",AU,AUTOMOBILE ENGINEERING,18,20,2
2711,"Kongu Engineering College (Autonomous), PerunduraiRailway Station Road,Thoppupalayam,Perundurai,Erode-638052.",CD,COMPUTER SCIENCE ANDDESIGN,105,87,-18
2711,"Kongu Engineering College (Autonomous), PerunduraiRailway Station Road,Thoppupalayam,Perundurai,Erode-638052.",CE,CIVIL  ENGINEERING,35,36,1
2711,"Kongu Engineering College (Autonomous), PerunduraiRailway Station Road,Thoppupalayam,Perundurai,Erode-638052.",CH,CHEMICAL  ENGINEERING,35,42,7
2711,"Kongu Engineering College (Autonomous), PerunduraiRailway Station Road,Thoppupalayam,Perundurai,Erode-638052.",CS,COMPUTER SCIENCE ANDENGINEERING,142,223,81
2711,"Kongu Engineering College (Autonomous), PerunduraiRailway Station Road,Thoppupalayam,Perundurai,Erode-638052.",EC,ELECTRONICS ANDCOMMUNICATIONENGINEERING,140,166,26
2711,"Kongu Engineering College (Autonomous), PerunduraiRailway Station Road,Thoppupalayam,Perundurai,Erode-638052.",EE,ELECTRICAL AND ELECTRONICSENGINEERING,70,71,1
2711,"Kongu Engineering College (Autonomous), PerunduraiRailway Station Road,Thoppupalayam,Perundurai,Erode-638052.",EI,ELECTRONICS ANDINSTRUMENTATIONENGINEERING,70,70,0
2711,"Kongu Engineering College (Autonomous), PerunduraiRailway Station Road,Thoppupalayam,Perundurai,Erode-638052.",FD,FOOD TECHNOLOGY,35,36,1
2711,"Kongu Engineering College (Autonomous), PerunduraiRailway Station Road,Thoppupalayam,Perundurai,Erode-638052.",IT,INFORMATION TECHNOLOGY,107,109,2
2711,"Kongu Engineering College (Autonomous), PerunduraiRailway Station Road,Thoppupalayam,Perundurai,Erode-638052.",ME,MECHANICAL ENGINEERING,34,36,2
2711,"Kongu Engineering College (Autonomous), PerunduraiRailway Station Road,Thoppupalayam,Perundurai,Erode-638052.",MZ,Mechatronics Engineering,70,70,0
2712,"Kumaraguru College of Technology (Autonomous),Chinnavedampatti, Coimbatore-641049.",AD,Artificial Intelligence and DataScience,69,70,1
2712,"Kumaraguru College of Technology (Autonomous),Chinnavedampatti, Coimbatore-641049.",AE,AERONAUTICAL ENGINEERING,41,41,0
2712,"Kumaraguru College of Technology (Autonomous),Chinnavedampatti, Coimbatore-641049.",AU,AUTOMOBILE ENGINEERING,44,35,-9
2712,"Kumaraguru College of Technology (Autonomous),Chinnavedampatti, Coimbatore-641049.",BT,BIO TECHNOLOGY,41,41,0
2712,"Kumaraguru College of Technology (Autonomous),Chinnavedampatti, Coimbatore-641049.",CE,CIVIL  ENGINEERING,81,71,-10
2712,"Kumaraguru College of Technology (Autonomous),Chinnavedampatti, Coimbatore-641049.",CS,COMPUTER SCIENCE ANDENGINEERING,104,177,73
2712,"Kumaraguru College of Technology (Autonomous),Chinnavedampatti, Coimbatore-641049.",EC,ELECTRONICS ANDCOMMUNICATIONENGINEERING,123,123,0
2712,"Kumaraguru College of Technology (Autonomous),Chinnavedampatti, Coimbatore-641049.",EE,ELECTRICAL AND ELECTRONICSENGINEERING,81,80,-1
2712,"Kumaraguru College of Technology (Autonomous),Chinnavedampatti, Coimbatore-641049.",EI,ELECTRONICS ANDINSTRUMENTATIONENGINEERING,40,40,0
2712,"Kumaraguru College of Technology (Autonomous),Chinnavedampatti, Coimbatore-641049.",FT,FASHION TECHNOLOGY,35,36,1
2712,"Kumaraguru College of Technology (Autonomous),Chinnavedampatti, Coimbatore-641049.",IT,INFORMATION TECHNOLOGY,68,76,8
2712,"Kumaraguru College of Technology (Autonomous),Chinnavedampatti, Coimbatore-641049.",ME,MECHANICAL ENGINEERING,71,70,-1
2712,"Kumaraguru College of Technology (Autonomous),Chinnavedampatti, Coimbatore-641049.",MZ,Mechatronics Engineering,41,41,0
2712,"Kumaraguru College of Technology (Autonomous),Chinnavedampatti, Coimbatore-641049.",TX,TEXTILE TECHNOLOGY,40,18,-22
2713,"M.P.Nachimuthu M.Jaganathan Engineering College,Chennimalai, Erode-638112.",CE,CIVIL  ENGINEERING,18,19,1
2713,"M.P.Nachimuthu M.Jaganathan Engineering College,Chennimalai, Erode-638112.",CS,COMPUTER SCIENCE ANDENGINEERING,46,49,3
2713,"M.P.Nachimuthu M.Jaganathan Engineering College,Chennimalai, Erode-638112.",EC,ELECTRONICS ANDCOMMUNICATIONENGINEERING,44,45,1
2713,"M.P.Nachimuthu M.Jaganathan Engineering College,Chennimalai, Erode-638112.",EE,ELECTRICAL AND ELECTRONICSENGINEERING,36,36,0
2713,"M.P.Nachimuthu M.Jaganathan Engineering College,Chennimalai, Erode-638112.",IT,INFORMATION TECHNOLOGY,50,45,-5
2713,"M.P.Nachimuthu M.Jaganathan Engineering College,Chennimalai, Erode-638112.",ME,MECHANICAL ENGINEERING,36,37,1
2715,"Nandha Engineering College (Autonomous), 28,Chennimalaipalayam Road, Pitchandampalayam Post,Erode-638052.",AD,Artificial Intelligence and DataScience,36,70,34
2715,"Nandha Engineering College (Autonomous), 28,Chennimalaipalayam Road, Pitchandampalayam Post,Erode-638052.",AG,AGRICULTURE ENGINEERING,49,49,0
2715,"Nandha Engineering College (Autonomous), 28,Chennimalaipalayam Road, Pitchandampalayam Post,Erode-638052.",BM,BIO MEDICAL ENGINEERING,42,40,-2
2715,"Nandha Engineering College (Autonomous), 28,Chennimalaipalayam Road, Pitchandampalayam Post,Erode-638052.",CE,CIVIL  ENGINEERING,24,28,4
2715,"Nandha Engineering College (Autonomous), 28,Chennimalaipalayam Road, Pitchandampalayam Post,Erode-638052.",CH,CHEMICAL  ENGINEERING,22,23,1
2715,"Nandha Engineering College (Autonomous), 28,Chennimalaipalayam Road, Pitchandampalayam Post,Erode-638052.",CI,Computer Science andEngineering (Internet of Things),35,35,0
2715,"Nandha Engineering College (Autonomous), 28,Chennimalaipalayam Road, Pitchandampalayam Post,Erode-638052.",CS,COMPUTER SCIENCE ANDENGINEERING,116,163,47
2715,"Nandha Engineering College (Autonomous), 28,Chennimalaipalayam Road, Pitchandampalayam Post,Erode-638052.",EC,ELECTRONICS ANDCOMMUNICATIONENGINEERING,70,71,1
2715,"Nandha Engineering College (Autonomous), 28,Chennimalaipalayam Road, Pitchandampalayam Post,Erode-638052.",EE,ELECTRICAL AND ELECTRONICSENGINEERING,41,36,-5
2715,"Nandha Engineering College (Autonomous), 28,Chennimalaipalayam Road, Pitchandampalayam Post,Erode-638052.",IT,INFORMATION TECHNOLOGY,93,70,-23
2715,"Nandha Engineering College (Autonomous), 28,Chennimalaipalayam Road, Pitchandampalayam Post,Erode-638052.",ME,MECHANICAL ENGINEERING,53,45,-8
2715,"Nandha Engineering College (Autonomous), 28,Chennimalaipalayam Road, Pitchandampalayam Post,Erode-638052.",SC,Computer Science andEngineering (Cyber Security),35,35,0
2716,"Park College of Engineering and Technology, AvinashiRoad (NH-47), Kaniyur,Coimbatore-641659.",AD,Artificial Intelligence and DataScience,35,36,1
2716,"Park College of Engineering and Technology, AvinashiRoad (NH-47), Kaniyur,Coimbatore-641659.",AE,AERONAUTICAL ENGINEERING,34,35,1
2716,"Park College of Engineering and Technology, AvinashiRoad (NH-47), Kaniyur,Coimbatore-641659.",AG,AGRICULTURE ENGINEERING,35,35,0
2716,"Park College of Engineering and Technology, AvinashiRoad (NH-47), Kaniyur,Coimbatore-641659.",BM,BIO MEDICAL ENGINEERING,35,35,0
2716,"Park College of Engineering and Technology, AvinashiRoad (NH-47), Kaniyur,Coimbatore-641659.",CS,COMPUTER SCIENCE ANDENGINEERING,35,52,17
2716,"Park College of Engineering and Technology, AvinashiRoad (NH-47), Kaniyur,Coimbatore-641659.",EC,ELECTRONICS ANDCOMMUNICATIONENGINEERING,35,36,1
2716,"Park College of Engineering and Technology, AvinashiRoad (NH-47), Kaniyur,Coimbatore-641659.",EE,ELECTRICAL AND ELECTRONICSENGINEERING,35,35,0
2716,"Park College of Engineering and Technology, AvinashiRoad (NH-47), Kaniyur,Coimbatore-641659.",GI,GEO INFORMATICS,17,18,1
2716,"Park College of Engineering and Technology, AvinashiRoad (NH-47), Kaniyur,Coimbatore-641659.",IT,INFORMATION TECHNOLOGY,54,53,-1
2716,"Park College of Engineering and Technology, AvinashiRoad (NH-47), Kaniyur,Coimbatore-641659.",MD,MEDICAL ELECTRONICSENGINEERING,19,18,-1
2716,"Park College of Engineering and Technology, AvinashiRoad (NH-47), Kaniyur,Coimbatore-641659.",ME,MECHANICAL ENGINEERING,35,35,0
2716,"Park College of Engineering and Technology, AvinashiRoad (NH-47), Kaniyur,Coimbatore-641659.",MZ,Mechatronics Engineering,18,19,1
2716,"Park College of Engineering and Technology, AvinashiRoad (NH-47), Kaniyur,Coimbatore-641659.",RM,ROBOTICS AND AUTOMATION,21,17,-4
2716,"Park College of Engineering and Technology, AvinashiRoad (NH-47), Kaniyur,Coimbatore-641659.",SC,Computer Science andEngineering (Cyber Security),21,18,-3
2716,"Park College of Engineering and Technology, AvinashiRoad (NH-47), Kaniyur,Coimbatore-641659.",TX,TEXTILE TECHNOLOGY,21,18,-3
2717,"Sasurie College of Engineering, Vijayamangalam,Tirupur District-638056.",AD,Artificial Intelligence and DataScience,54,54,0
2717,"Sasurie College of Engineering, Vijayamangalam,Tirupur District-638056.",CE,CIVIL  ENGINEERING,27,27,0
2717,"Sasurie College of Engineering, Vijayamangalam,Tirupur District-638056.",CS,COMPUTER SCIENCE ANDENGINEERING,108,110,2
2717,"Sasurie College of Engineering, Vijayamangalam,Tirupur District-638056.",EC,ELECTRONICS ANDCOMMUNICATIONENGINEERING,109,109,0
2717,"Sasurie College of Engineering, Vijayamangalam,Tirupur District-638056.",EE,ELECTRICAL AND ELECTRONICSENGINEERING,26,26,0
2717,"Sasurie College of Engineering, Vijayamangalam,Tirupur District-638056.",IT,INFORMATION TECHNOLOGY,55,55,0
2717,"Sasurie College of Engineering, Vijayamangalam,Tirupur District-638056.",ME,MECHANICAL ENGINEERING,54,54,0
2717,"Sasurie College of Engineering, Vijayamangalam,Tirupur District-638056.",SC,Computer Science andEngineering (Cyber Security),55,54,-1
2718,"Sri Krishna College of Engineering and Technology(Autonomous), Sugunapuram, Kuniamuthur Post,Coimbatore-641008.",AD,Artificial Intelligence and DataScience,74,105,31
2718,"Sri Krishna College of Engineering and Technology(Autonomous), Sugunapuram, Kuniamuthur Post,Coimbatore-641008.",CB,COMPUTER SCIENCE ANDBUSSINESS SYSTEM,41,41,0
2718,"Sri Krishna College of Engineering and Technology(Autonomous), Sugunapuram, Kuniamuthur Post,Coimbatore-641008.",CD,COMPUTER SCIENCE ANDDESIGN,35,36,1
2718,"Sri Krishna College of Engineering and Technology(Autonomous), Sugunapuram, Kuniamuthur Post,Coimbatore-641008.",CE,CIVIL  ENGINEERING,41,41,0
2718,"Sri Krishna College of Engineering and Technology(Autonomous), Sugunapuram, Kuniamuthur Post,Coimbatore-641008.",CJ,M.Tech. Computer Science andEngineering (Integrated 5years),35,36,1
2718,"Sri Krishna College of Engineering and Technology(Autonomous), Sugunapuram, Kuniamuthur Post,Coimbatore-641008.",CS,COMPUTER SCIENCE ANDENGINEERING,156,177,21
2718,"Sri Krishna College of Engineering and Technology(Autonomous), Sugunapuram, Kuniamuthur Post,Coimbatore-641008.",EC,ELECTRONICS ANDCOMMUNICATIONENGINEERING,120,141,21
2718,"Sri Krishna College of Engineering and Technology(Autonomous), Sugunapuram, Kuniamuthur Post,Coimbatore-641008.",EE,ELECTRICAL AND ELECTRONICSENGINEERING,81,81,0
2718,"Sri Krishna College of Engineering and Technology(Autonomous), Sugunapuram, Kuniamuthur Post,Coimbatore-641008.",IT,INFORMATION TECHNOLOGY,157,176,19
2718,"Sri Krishna College of Engineering and Technology(Autonomous), Sugunapuram, Kuniamuthur Post,Coimbatore-641008.",ME,MECHANICAL ENGINEERING,81,81,0
2718,"Sri Krishna College of Engineering and Technology(Autonomous), Sugunapuram, Kuniamuthur Post,Coimbatore-641008.",MZ,Mechatronics Engineering,81,81,0
2718,"Sri Krishna College of Engineering and Technology(Autonomous), Sugunapuram, Kuniamuthur Post,Coimbatore-641008.",SC,Computer Science andEngineering (Cyber Security),35,71,36
2719,"Sri Ramakrishna Engineering College (Autonomous),Vattamalaipalayam, NGGO Colony Post,  Coimbatore-641022.",AD,Artificial Intelligence and DataScience,36,35,-1
2719,"Sri Ramakrishna Engineering College (Autonomous),Vattamalaipalayam, NGGO Colony Post,  Coimbatore-641022.",AE,AERONAUTICAL ENGINEERING,18,18,0
2719,"Sri Ramakrishna Engineering College (Autonomous),Vattamalaipalayam, NGGO Colony Post,  Coimbatore-641022.",BM,BIO MEDICAL ENGINEERING,35,35,0
2719,"Sri Ramakrishna Engineering College (Autonomous),Vattamalaipalayam, NGGO Colony Post,  Coimbatore-641022.",CE,CIVIL  ENGINEERING,49,47,-2
2719,"Sri Ramakrishna Engineering College (Autonomous),Vattamalaipalayam, NGGO Colony Post,  Coimbatore-641022.",CJ,M.Tech. Computer Science andEngineering (Integrated 5years),35,35,0
2719,"Sri Ramakrishna Engineering College (Autonomous),Vattamalaipalayam, NGGO Colony Post,  Coimbatore-641022.",CS,COMPUTER SCIENCE ANDENGINEERING,106,106,0
2719,"Sri Ramakrishna Engineering College (Autonomous),Vattamalaipalayam, NGGO Colony Post,  Coimbatore-641022.",EC,ELECTRONICS ANDCOMMUNICATIONENGINEERING,104,106,2
2719,"Sri Ramakrishna Engineering College (Autonomous),Vattamalaipalayam, NGGO Colony Post,  Coimbatore-641022.",EE,ELECTRICAL AND ELECTRONICSENGINEERING,53,53,0
2719,"Sri Ramakrishna Engineering College (Autonomous),Vattamalaipalayam, NGGO Colony Post,  Coimbatore-641022.",EI,ELECTRONICS ANDINSTRUMENTATIONENGINEERING,35,35,0
2719,"Sri Ramakrishna Engineering College (Autonomous),Vattamalaipalayam, NGGO Colony Post,  Coimbatore-641022.",IT,INFORMATION TECHNOLOGY,70,71,1
2719,"Sri Ramakrishna Engineering College (Autonomous),Vattamalaipalayam, NGGO Colony Post,  Coimbatore-641022.",ME,MECHANICAL ENGINEERING,53,54,1
2719,"Sri Ramakrishna Engineering College (Autonomous),Vattamalaipalayam, NGGO Colony Post,  Coimbatore-641022.",RM,ROBOTICS AND AUTOMATION,35,35,0
2721,"Tamilnadu College of Engineering, Palanisame RaviNagar, Karumathampatti Post, Coimbatore-641659.",AD,Artificial Intelligence and DataScience,18,35,17
2721,"Tamilnadu College of Engineering, Palanisame RaviNagar, Karumathampatti Post, Coimbatore-641659.",AU,AUTOMOBILE ENGINEERING,22,18,-4
2721,"Tamilnadu College of Engineering, Palanisame RaviNagar, Karumathampatti Post, Coimbatore-641659.",CE,CIVIL  ENGINEERING,23,18,-5
2721,"Tamilnadu College of Engineering, Palanisame RaviNagar, Karumathampatti Post, Coimbatore-641659.",CS,COMPUTER SCIENCE ANDENGINEERING,35,35,0
2721,"Tamilnadu College of Engineering, Palanisame RaviNagar, Karumathampatti Post, Coimbatore-641659.",EC,ELECTRONICS ANDCOMMUNICATIONENGINEERING,36,35,-1
2721,"Tamilnadu College of Engineering, Palanisame RaviNagar, Karumathampatti Post, Coimbatore-641659.",EE,ELECTRICAL AND ELECTRONICSENGINEERING,23,18,-5
2721,"Tamilnadu College of Engineering, Palanisame RaviNagar, Karumathampatti Post, Coimbatore-641659.",IC,INSTRUMENTATION ANDCONTROL ENGINEERING,23,17,-6
2721,"Tamilnadu College of Engineering, Palanisame RaviNagar, Karumathampatti Post, Coimbatore-641659.",IT,INFORMATION TECHNOLOGY,36,35,-1
2721,"Tamilnadu College of Engineering, Palanisame RaviNagar, Karumathampatti Post, Coimbatore-641659.",ME,MECHANICAL ENGINEERING,23,18,-5
2722,"Sri Krishna College of Technology (Autonomous),Kovaipudur Post, Coimbatore-641042.",AD,Artificial Intelligence and DataScience,69,105,36
2722,"Sri Krishna College of Technology (Autonomous),Kovaipudur Post, Coimbatore-641042.",AM,COMPUTER SCIENCE ANDENGINEERING (AI ANDMACHINE LEARNING),35,36,1
2722,"Sri Krishna College of Technology (Autonomous),Kovaipudur Post, Coimbatore-641042.",CE,CIVIL  ENGINEERING,44,36,-8
2722,"Sri Krishna College of Technology (Autonomous),Kovaipudur Post, Coimbatore-641042.",CI,Computer Science andEngineering (Internet of Things),35,36,1
2722,"Sri Krishna College of Technology (Autonomous),Kovaipudur Post, Coimbatore-641042.",CS,COMPUTER SCIENCE ANDENGINEERING,141,177,36
2722,"Sri Krishna College of Technology (Autonomous),Kovaipudur Post, Coimbatore-641042.",EC,ELECTRONICS ANDCOMMUNICATIONENGINEERING,106,105,-1
2722,"Sri Krishna College of Technology (Autonomous),Kovaipudur Post, Coimbatore-641042.",EE,ELECTRICAL AND ELECTRONICSENGINEERING,70,71,1
2722,"Sri Krishna College of Technology (Autonomous),Kovaipudur Post, Coimbatore-641042.",IT,INFORMATION TECHNOLOGY,106,105,-1
2722,"Sri Krishna College of Technology (Autonomous),Kovaipudur Post, Coimbatore-641042.",ME,MECHANICAL ENGINEERING,45,36,-9
2722,"Sri Krishna College of Technology (Autonomous),Kovaipudur Post, Coimbatore-641042.",SC,Computer Science andEngineering (Cyber Security),36,36,0
2723,"Velalar College of Engineering and Technology(Autonomous), Perundurai Road Thindal Post, Erode-638012.",AD,Artificial Intelligence and DataScience,34,70,36
2723,"Velalar College of Engineering and Technology(Autonomous), Perundurai Road Thindal Post, Erode-638012.",AM,COMPUTER SCIENCE ANDENGINEERING (AI ANDMACHINE LEARNING),35,36,1
2723,"Velalar College of Engineering and Technology(Autonomous), Perundurai Road Thindal Post, Erode-638012.",BM,BIO MEDICAL ENGINEERING,71,70,-1
2723,"Velalar College of Engineering and Technology(Autonomous), Perundurai Road Thindal Post, Erode-638012.",CE,CIVIL  ENGINEERING,18,23,5
2723,"Velalar College of Engineering and Technology(Autonomous), Perundurai Road Thindal Post, Erode-638012.",CS,COMPUTER SCIENCE ANDENGINEERING,70,105,35
2723,"Velalar College of Engineering and Technology(Autonomous), Perundurai Road Thindal Post, Erode-638012.",EC,ELECTRONICS ANDCOMMUNICATIONENGINEERING,107,106,-1
2723,"Velalar College of Engineering and Technology(Autonomous), Perundurai Road Thindal Post, Erode-638012.",EE,ELECTRICAL AND ELECTRONICSENGINEERING,35,36,1
2723,"Velalar College of Engineering and Technology(Autonomous), Perundurai Road Thindal Post, Erode-638012.",IT,INFORMATION TECHNOLOGY,71,70,-1
2723,"Velalar College of Engineering and Technology(Autonomous), Perundurai Road Thindal Post, Erode-638012.",MD,MEDICAL ELECTRONICSENGINEERING,35,35,0
2723,"Velalar College of Engineering and Technology(Autonomous), Perundurai Road Thindal Post, Erode-638012.",ME,MECHANICAL ENGINEERING,35,36,1
2725,"Sri Ramakrishna Institute of Technology(Autonomous), Pachapalayam, Perur Chettipalayam,Coimbatore-641010.",CS,COMPUTER SCIENCE ANDENGINEERING,105,106,1
2725,"Sri Ramakrishna Institute of Technology(Autonomous), Pachapalayam, Perur Chettipalayam,Coimbatore-641010.",EC,ELECTRONICS ANDCOMMUNICATIONENGINEERING,35,35,0
2725,"Sri Ramakrishna Institute of Technology(Autonomous), Pachapalayam, Perur Chettipalayam,Coimbatore-641010.",EE,ELECTRICAL AND ELECTRONICSENGINEERING,18,18,0
2725,"Sri Ramakrishna Institute of Technology(Autonomous), Pachapalayam, Perur Chettipalayam,Coimbatore-641010.",IT,INFORMATION TECHNOLOGY,34,35,1
2725,"Sri Ramakrishna Institute of Technology(Autonomous), Pachapalayam, Perur Chettipalayam,Coimbatore-641010.",ME,MECHANICAL ENGINEERING,22,22,0
2726,"SNS College of Technology (Autonomous), Sathy MainRoad, Vazhiyampalayam, Saravanampatti Post,Coimbatore-641035.",AG,AGRICULTURE ENGINEERING,35,35,0
2726,"SNS College of Technology (Autonomous), Sathy MainRoad, Vazhiyampalayam, Saravanampatti Post,Coimbatore-641035.",AL,Artificial Intelligence andMachine Learning,70,79,9
2726,"SNS College of Technology (Autonomous), Sathy MainRoad, Vazhiyampalayam, Saravanampatti Post,Coimbatore-641035.",AO,AEROSPACE ENGINEERING,18,18,0
2726,"SNS College of Technology (Autonomous), Sathy MainRoad, Vazhiyampalayam, Saravanampatti Post,Coimbatore-641035.",AU,AUTOMOBILE ENGINEERING,18,22,4
2726,"SNS College of Technology (Autonomous), Sathy MainRoad, Vazhiyampalayam, Saravanampatti Post,Coimbatore-641035.",BM,BIO MEDICAL ENGINEERING,35,40,5
2726,"SNS College of Technology (Autonomous), Sathy MainRoad, Vazhiyampalayam, Saravanampatti Post,Coimbatore-641035.",CE,CIVIL  ENGINEERING,35,35,0
2726,"SNS College of Technology (Autonomous), Sathy MainRoad, Vazhiyampalayam, Saravanampatti Post,Coimbatore-641035.",CS,COMPUTER SCIENCE ANDENGINEERING,104,111,7
2726,"SNS College of Technology (Autonomous), Sathy MainRoad, Vazhiyampalayam, Saravanampatti Post,Coimbatore-641035.",EC,ELECTRONICS ANDCOMMUNICATIONENGINEERING,89,114,25
2726,"SNS College of Technology (Autonomous), Sathy MainRoad, Vazhiyampalayam, Saravanampatti Post,Coimbatore-641035.",EE,ELECTRICAL AND ELECTRONICSENGINEERING,35,40,5
2726,"SNS College of Technology (Autonomous), Sathy MainRoad, Vazhiyampalayam, Saravanampatti Post,Coimbatore-641035.",FD,FOOD TECHNOLOGY,36,36,0
2726,"SNS College of Technology (Autonomous), Sathy MainRoad, Vazhiyampalayam, Saravanampatti Post,Coimbatore-641035.",IT,INFORMATION TECHNOLOGY,35,40,5
2726,"SNS College of Technology (Autonomous), Sathy MainRoad, Vazhiyampalayam, Saravanampatti Post,Coimbatore-641035.",ME,MECHANICAL ENGINEERING,54,54,0
2726,"SNS College of Technology (Autonomous), Sathy MainRoad, Vazhiyampalayam, Saravanampatti Post,Coimbatore-641035.",MZ,Mechatronics Engineering,35,35,0
2727,"Sri Shakthi Institute of Engineering and Technology(Autonomous), Sri Shakthi Nagar, L & T By-pass Road,Chinniyampalayam Post, Coimbatore-641062.",AD,Artificial Intelligence and DataScience,129,199,70
2727,"Sri Shakthi Institute of Engineering and Technology(Autonomous), Sri Shakthi Nagar, L & T By-pass Road,Chinniyampalayam Post, Coimbatore-641062.",AG,AGRICULTURE ENGINEERING,35,54,19
2727,"Sri Shakthi Institute of Engineering and Technology(Autonomous), Sri Shakthi Nagar, L & T By-pass Road,Chinniyampalayam Post, Coimbatore-641062.",AL,Artificial Intelligence andMachine Learning,109,108,-1
2727,"Sri Shakthi Institute of Engineering and Technology(Autonomous), Sri Shakthi Nagar, L & T By-pass Road,Chinniyampalayam Post, Coimbatore-641062.",BM,BIO MEDICAL ENGINEERING,49,54,5
2727,"Sri Shakthi Institute of Engineering and Technology(Autonomous), Sri Shakthi Nagar, L & T By-pass Road,Chinniyampalayam Post, Coimbatore-641062.",BT,BIO TECHNOLOGY,35,46,11
2727,"Sri Shakthi Institute of Engineering and Technology(Autonomous), Sri Shakthi Nagar, L & T By-pass Road,Chinniyampalayam Post, Coimbatore-641062.",CE,CIVIL  ENGINEERING,35,54,19
2727,"Sri Shakthi Institute of Engineering and Technology(Autonomous), Sri Shakthi Nagar, L & T By-pass Road,Chinniyampalayam Post, Coimbatore-641062.",CS,COMPUTER SCIENCE ANDENGINEERING,130,182,52
2727,"Sri Shakthi Institute of Engineering and Technology(Autonomous), Sri Shakthi Nagar, L & T By-pass Road,Chinniyampalayam Post, Coimbatore-641062.",EC,ELECTRONICS ANDCOMMUNICATIONENGINEERING,109,109,0
2727,"Sri Shakthi Institute of Engineering and Technology(Autonomous), Sri Shakthi Nagar, L & T By-pass Road,Chinniyampalayam Post, Coimbatore-641062.",EE,ELECTRICAL AND ELECTRONICSENGINEERING,38,45,7
2727,"Sri Shakthi Institute of Engineering and Technology(Autonomous), Sri Shakthi Nagar, L & T By-pass Road,Chinniyampalayam Post, Coimbatore-641062.",EV,Electronics Engineering (VLSIDesign and Technology),0,54,54
2727,"Sri Shakthi Institute of Engineering and Technology(Autonomous), Sri Shakthi Nagar, L & T By-pass Road,Chinniyampalayam Post, Coimbatore-641062.",FD,FOOD TECHNOLOGY,41,45,4
2727,"Sri Shakthi Institute of Engineering and Technology(Autonomous), Sri Shakthi Nagar, L & T By-pass Road,Chinniyampalayam Post, Coimbatore-641062.",IT,INFORMATION TECHNOLOGY,156,164,8
2727,"Sri Shakthi Institute of Engineering and Technology(Autonomous), Sri Shakthi Nagar, L & T By-pass Road,Chinniyampalayam Post, Coimbatore-641062.",ME,MECHANICAL ENGINEERING,41,45,4
2727,"Sri Shakthi Institute of Engineering and Technology(Autonomous), Sri Shakthi Nagar, L & T By-pass Road,Chinniyampalayam Post, Coimbatore-641062.",SC,Computer Science andEngineering (Cyber Security),109,110,1
2729,"Nehru Institute of Engineering and Technology(Autonomous), Nehru Gardens,Thirumalayampalayam (Post), Coimbatore-641105.",AD,Artificial Intelligence and DataScience,36,71,35
2729,"Nehru Institute of Engineering and Technology(Autonomous), Nehru Gardens,Thirumalayampalayam (Post), Coimbatore-641105.",AE,AERONAUTICAL ENGINEERING,70,70,0
2729,"Nehru Institute of Engineering and Technology(Autonomous), Nehru Gardens,Thirumalayampalayam (Post), Coimbatore-641105.",CB,COMPUTER SCIENCE ANDBUSSINESS SYSTEM,36,36,0
2729,"Nehru Institute of Engineering and Technology(Autonomous), Nehru Gardens,Thirumalayampalayam (Post), Coimbatore-641105.",CS,COMPUTER SCIENCE ANDENGINEERING,34,36,2
2729,"Nehru Institute of Engineering and Technology(Autonomous), Nehru Gardens,Thirumalayampalayam (Post), Coimbatore-641105.",EC,ELECTRONICS ANDCOMMUNICATIONENGINEERING,70,70,0
2729,"Nehru Institute of Engineering and Technology(Autonomous), Nehru Gardens,Thirumalayampalayam (Post), Coimbatore-641105.",EE,ELECTRICAL AND ELECTRONICSENGINEERING,35,35,0
2729,"Nehru Institute of Engineering and Technology(Autonomous), Nehru Gardens,Thirumalayampalayam (Post), Coimbatore-641105.",IT,INFORMATION TECHNOLOGY,35,36,1
2729,"Nehru Institute of Engineering and Technology(Autonomous), Nehru Gardens,Thirumalayampalayam (Post), Coimbatore-641105.",ME,MECHANICAL ENGINEERING,36,36,0
2729,"Nehru Institute of Engineering and Technology(Autonomous), Nehru Gardens,Thirumalayampalayam (Post), Coimbatore-641105.",MZ,Mechatronics Engineering,35,35,0
2731,"RVS College of Engineering and Technology(Autonomous), Kumaran Kottam Campus,Kannampalayam Post, Coimbatore-641402.",AD,Artificial Intelligence and DataScience,53,51,-2
2731,"RVS College of Engineering and Technology(Autonomous), Kumaran Kottam Campus,Kannampalayam Post, Coimbatore-641402.",BM,BIO MEDICAL ENGINEERING,0,17,17
2731,"RVS College of Engineering and Technology(Autonomous), Kumaran Kottam Campus,Kannampalayam Post, Coimbatore-641402.",CS,COMPUTER SCIENCE ANDENGINEERING,35,70,35
2731,"RVS College of Engineering and Technology(Autonomous), Kumaran Kottam Campus,Kannampalayam Post, Coimbatore-641402.",EC,ELECTRONICS ANDCOMMUNICATIONENGINEERING,34,35,1
2731,"RVS College of Engineering and Technology(Autonomous), Kumaran Kottam Campus,Kannampalayam Post, Coimbatore-641402.",EE,ELECTRICAL AND ELECTRONICSENGINEERING,18,18,0
2731,"RVS College of Engineering and Technology(Autonomous), Kumaran Kottam Campus,Kannampalayam Post, Coimbatore-641402.",IT,INFORMATION TECHNOLOGY,35,37,2
2731,"RVS College of Engineering and Technology(Autonomous), Kumaran Kottam Campus,Kannampalayam Post, Coimbatore-641402.",ME,MECHANICAL ENGINEERING,18,19,1
2731,"RVS College of Engineering and Technology(Autonomous), Kumaran Kottam Campus,Kannampalayam Post, Coimbatore-641402.",MU,MECHANICAL ANDAUTOMATION ENGINEERING,0,18,18
2731,R V S College of Engineering and TechnologyKannampalayam  Sulur  Coimbatore District 641402,PC,PETRO CHEMICALTECHNOLOGY,18,0,-18
2731,"RVS College of Engineering and Technology(Autonomous), Kumaran Kottam Campus,Kannampalayam Post, Coimbatore-641402.",PD,PETRO CHEMICALENGINEERING,0,18,18
2732,"Info Institute of Engineering, S F No.194-200,N.H.209, Sathy Road, Sarakarsamakulam,Kovilpalayam, Coimbatore-641107.",AD,Artificial Intelligence and DataScience,45,46,1
2732,"Info Institute of Engineering, S F No.194-200,N.H.209, Sathy Road, Sarakarsamakulam,Kovilpalayam, Coimbatore-641107.",CS,COMPUTER SCIENCE ANDENGINEERING,64,70,6
2732,"Info Institute of Engineering, S F No.194-200,N.H.209, Sathy Road, Sarakarsamakulam,Kovilpalayam, Coimbatore-641107.",EC,ELECTRONICS ANDCOMMUNICATIONENGINEERING,34,45,11
2732,"Info Institute of Engineering, S F No.194-200,N.H.209, Sathy Road, Sarakarsamakulam,Kovilpalayam, Coimbatore-641107.",EE,ELECTRICAL AND ELECTRONICSENGINEERING,19,24,5
2732,"Info Institute of Engineering, S F No.194-200,N.H.209, Sathy Road, Sarakarsamakulam,Kovilpalayam, Coimbatore-641107.",IT,INFORMATION TECHNOLOGY,35,46,11
2732,"Info Institute of Engineering, S F No.194-200,N.H.209, Sathy Road, Sarakarsamakulam,Kovilpalayam, Coimbatore-641107.",ME,MECHANICAL ENGINEERING,35,45,10
2733,"Angel College of Engineering and Technology, PKPalayam PO,Dharapuram Main Road, Ugayanurvillage, Tiruppur-641665.",CE,CIVIL  ENGINEERING,35,35,0
2733,"Angel College of Engineering and Technology, PKPalayam PO,Dharapuram Main Road, Ugayanurvillage, Tiruppur-641665.",CS,COMPUTER SCIENCE ANDENGINEERING,45,36,-9
2733,"Angel College of Engineering and Technology, PKPalayam PO,Dharapuram Main Road, Ugayanurvillage, Tiruppur-641665.",EC,ELECTRONICS ANDCOMMUNICATIONENGINEERING,54,36,-18
2733,"Angel College of Engineering and Technology, PKPalayam PO,Dharapuram Main Road, Ugayanurvillage, Tiruppur-641665.",EE,ELECTRICAL AND ELECTRONICSENGINEERING,35,36,1
2733,"Angel College of Engineering and Technology, PKPalayam PO,Dharapuram Main Road, Ugayanurvillage, Tiruppur-641665.",FT,FASHION TECHNOLOGY,36,35,-1
2733,"Angel College of Engineering and Technology, PKPalayam PO,Dharapuram Main Road, Ugayanurvillage, Tiruppur-641665.",ME,MECHANICAL ENGINEERING,35,35,0
2734,"SNS College of Engineering (Autonomous), SathyMain Road, Kurumbapalayam Post, Coimbatore-641107.",AD,Artificial Intelligence and DataScience,69,80,11
2734,"SNS College of Engineering (Autonomous), SathyMain Road, Kurumbapalayam Post, Coimbatore-641107.",CD,COMPUTER SCIENCE ANDDESIGN,35,39,4
2734,"SNS College of Engineering (Autonomous), SathyMain Road, Kurumbapalayam Post, Coimbatore-641107.",CS,COMPUTER SCIENCE ANDENGINEERING,53,63,10
2734,"SNS College of Engineering (Autonomous), SathyMain Road, Kurumbapalayam Post, Coimbatore-641107.",EC,ELECTRONICS ANDCOMMUNICATIONENGINEERING,35,40,5
2734,"SNS College of Engineering (Autonomous), SathyMain Road, Kurumbapalayam Post, Coimbatore-641107.",EE,ELECTRICAL AND ELECTRONICSENGINEERING,18,22,4
2734,"SNS College of Engineering (Autonomous), SathyMain Road, Kurumbapalayam Post, Coimbatore-641107.",IT,INFORMATION TECHNOLOGY,35,44,9
2734,"SNS College of Engineering (Autonomous), SathyMain Road, Kurumbapalayam Post, Coimbatore-641107.",ME,MECHANICAL ENGINEERING,35,35,0
2734,"SNS College of Engineering (Autonomous), SathyMain Road, Kurumbapalayam Post, Coimbatore-641107.",MO,Mechanical and MechatronicsEngineering (AdditiveManufacturing),35,36,1
2734,"SNS College of Engineering (Autonomous), SathyMain Road, Kurumbapalayam Post, Coimbatore-641107.",SB,Computer Science andEngineering (Internet of Thingsand Cyber Security includingBlock Chain Technology),36,45,9
2734,"SNS College of Engineering (Autonomous), SathyMain Road, Kurumbapalayam Post, Coimbatore-641107.",TS,Computer Science andTechnology,35,44,9
2735,"Karpagam Institute of Technology (Autonomous), S.F.NO. 247,248, L&T Bypass Road, Seerapalayam Village,Bodipalayam Post, Coimbatore-641105.",AD,Artificial Intelligence and DataScience,28,27,-1
2735,"Karpagam Institute of Technology (Autonomous), S.F.NO. 247,248, L&T Bypass Road, Seerapalayam Village,Bodipalayam Post, Coimbatore-641105.",CS,COMPUTER SCIENCE ANDENGINEERING,53,55,2
2735,"Karpagam Institute of Technology (Autonomous), S.F.NO. 247,248, L&T Bypass Road, Seerapalayam Village,Bodipalayam Post, Coimbatore-641105.",EC,ELECTRONICS ANDCOMMUNICATIONENGINEERING,81,81,0
2735,"Karpagam Institute of Technology (Autonomous), S.F.NO. 247,248, L&T Bypass Road, Seerapalayam Village,Bodipalayam Post, Coimbatore-641105.",EE,ELECTRICAL AND ELECTRONICSENGINEERING,27,27,0
2735,"Karpagam Institute of Technology (Autonomous), S.F.NO. 247,248, L&T Bypass Road, Seerapalayam Village,Bodipalayam Post, Coimbatore-641105.",IT,INFORMATION TECHNOLOGY,27,27,0
2735,"Karpagam Institute of Technology (Autonomous), S.F.NO. 247,248, L&T Bypass Road, Seerapalayam Village,Bodipalayam Post, Coimbatore-641105.",ME,MECHANICAL ENGINEERING,40,41,1
2736,"Dr N.G.P. Institute of Technology (Autonomous), Dr.N.G.P. Nagar, Kalapatti Road, Coimbatore-641048.",AD,Artificial Intelligence and DataScience,70,70,0
2736,"Dr N.G.P. Institute of Technology (Autonomous), Dr.N.G.P. Nagar, Kalapatti Road, Coimbatore-641048.",BM,BIO MEDICAL ENGINEERING,36,35,-1
2736,"Dr N.G.P. Institute of Technology (Autonomous), Dr.N.G.P. Nagar, Kalapatti Road, Coimbatore-641048.",CB,COMPUTER SCIENCE ANDBUSSINESS SYSTEM,35,35,0
2736,"Dr N.G.P. Institute of Technology (Autonomous), Dr.N.G.P. Nagar, Kalapatti Road, Coimbatore-641048.",CE,CIVIL  ENGINEERING,17,16,-1
2736,"Dr N.G.P. Institute of Technology (Autonomous), Dr.N.G.P. Nagar, Kalapatti Road, Coimbatore-641048.",CS,COMPUTER SCIENCE ANDENGINEERING,70,106,36
2736,"Dr N.G.P. Institute of Technology (Autonomous), Dr.N.G.P. Nagar, Kalapatti Road, Coimbatore-641048.",EC,ELECTRONICS ANDCOMMUNICATIONENGINEERING,70,71,1
2736,"Dr N.G.P. Institute of Technology (Autonomous), Dr.N.G.P. Nagar, Kalapatti Road, Coimbatore-641048.",EE,ELECTRICAL AND ELECTRONICSENGINEERING,35,36,1
2736,"Dr N.G.P. Institute of Technology (Autonomous), Dr.N.G.P. Nagar, Kalapatti Road, Coimbatore-641048.",IT,INFORMATION TECHNOLOGY,36,71,35
2736,"Dr N.G.P. Institute of Technology (Autonomous), Dr.N.G.P. Nagar, Kalapatti Road, Coimbatore-641048.",ME,MECHANICAL ENGINEERING,35,36,1
2736,"Dr N.G.P. Institute of Technology (Autonomous), Dr.N.G.P. Nagar, Kalapatti Road, Coimbatore-641048.",SC,Computer Science andEngineering (Cyber Security),35,36,1
2737,"Sri Sai Ranganathan Engineering College , ViraliyurPost, Thondamuthur(via), Coimbatore-641109.",AD,Artificial Intelligence and DataScience,0,35,35
2737,"Sri Sai Ranganathan Engineering College , ViraliyurPost, Thondamuthur(via), Coimbatore-641109.",AM,COMPUTER SCIENCE ANDENGINEERING (AI ANDMACHINE LEARNING),18,19,1
2737,"Sri Sai Ranganathan Engineering College , ViraliyurPost, Thondamuthur(via), Coimbatore-641109.",CE,CIVIL  ENGINEERING,44,22,-22
2737,"Sri Sai Ranganathan Engineering College , ViraliyurPost, Thondamuthur(via), Coimbatore-641109.",CS,COMPUTER SCIENCE ANDENGINEERING,34,35,1
2737,"Sri Sai Ranganathan Engineering College , ViraliyurPost, Thondamuthur(via), Coimbatore-641109.",EC,ELECTRONICS ANDCOMMUNICATIONENGINEERING,35,35,0
2737,"Sri Sai Ranganathan Engineering College , ViraliyurPost, Thondamuthur(via), Coimbatore-641109.",EE,ELECTRICAL AND ELECTRONICSENGINEERING,18,20,2
2737,"Sri Sai Ranganathan Engineering College , ViraliyurPost, Thondamuthur(via), Coimbatore-641109.",IT,INFORMATION TECHNOLOGY,17,36,19
2737,"Sri Sai Ranganathan Engineering College , ViraliyurPost, Thondamuthur(via), Coimbatore-641109.",ME,MECHANICAL ENGINEERING,45,45,0
2737,"Sri Sai Ranganathan Engineering College , ViraliyurPost, Thondamuthur(via), Coimbatore-641109.",SC,Computer Science andEngineering (Cyber Security),18,18,0
2739,"Sri Eshwar College of Engineering (Autonomous),Kondampatti Post, Vadasithur Via, Coimbatore-641202.",AD,Artificial Intelligence and DataScience,89,140,51
2739,"Sri Eshwar College of Engineering (Autonomous),Kondampatti Post, Vadasithur Via, Coimbatore-641202.",AM,COMPUTER SCIENCE ANDENGINEERING (AI ANDMACHINE LEARNING),34,71,37
2739,"Sri Eshwar College of Engineering (Autonomous),Kondampatti Post, Vadasithur Via, Coimbatore-641202.",CB,COMPUTER SCIENCE ANDBUSSINESS SYSTEM,35,36,1
2739,"Sri Eshwar College of Engineering (Autonomous),Kondampatti Post, Vadasithur Via, Coimbatore-641202.",CO,COMPUTER ANDCOMMUNICATIONENGINEERING,35,36,1
2739,"Sri Eshwar College of Engineering (Autonomous),Kondampatti Post, Vadasithur Via, Coimbatore-641202.",CS,COMPUTER SCIENCE ANDENGINEERING,107,141,34
2739,"Sri Eshwar College of Engineering (Autonomous),Kondampatti Post, Vadasithur Via, Coimbatore-641202.",EC,ELECTRONICS ANDCOMMUNICATIONENGINEERING,105,105,0
2739,"Sri Eshwar College of Engineering (Autonomous),Kondampatti Post, Vadasithur Via, Coimbatore-641202.",EE,ELECTRICAL AND ELECTRONICSENGINEERING,35,36,1
2739,"Sri Eshwar College of Engineering (Autonomous),Kondampatti Post, Vadasithur Via, Coimbatore-641202.",IT,INFORMATION TECHNOLOGY,35,36,1
2739,"Sri Eshwar College of Engineering (Autonomous),Kondampatti Post, Vadasithur Via, Coimbatore-641202.",ME,MECHANICAL ENGINEERING,18,17,-1
2739,"Sri Eshwar College of Engineering (Autonomous),Kondampatti Post, Vadasithur Via, Coimbatore-641202.",SC,Computer Science andEngineering (Cyber Security),0,36,36
2740,"Hindusthan Institute of Technology (Autonomous),Othakkalmandapam Post, Coimbatore-641032.",AD,Artificial Intelligence and DataScience,34,71,37
2740,"Hindusthan Institute of Technology (Autonomous),Othakkalmandapam Post, Coimbatore-641032.",AE,AERONAUTICAL ENGINEERING,35,36,1
2740,"Hindusthan Institute of Technology (Autonomous),Othakkalmandapam Post, Coimbatore-641032.",CS,COMPUTER SCIENCE ANDENGINEERING,105,105,0
2740,"Hindusthan Institute of Technology (Autonomous),Othakkalmandapam Post, Coimbatore-641032.",EC,ELECTRONICS ANDCOMMUNICATIONENGINEERING,71,71,0
2740,"Hindusthan Institute of Technology (Autonomous),Othakkalmandapam Post, Coimbatore-641032.",IT,INFORMATION TECHNOLOGY,71,70,-1
2740,"Hindusthan Institute of Technology (Autonomous),Othakkalmandapam Post, Coimbatore-641032.",ME,MECHANICAL ENGINEERING,35,36,1
2741,"P A College of Engineering and Technology(Autonomous), Palladam Road, Pollachi, CoimbatoreDt.-642002.",AD,Artificial Intelligence and DataScience,36,70,34
2741,"P A College of Engineering and Technology(Autonomous), Palladam Road, Pollachi, CoimbatoreDt.-642002.",CE,CIVIL  ENGINEERING,0,23,23
2741,"P A College of Engineering and Technology(Autonomous), Palladam Road, Pollachi, CoimbatoreDt.-642002.",CS,COMPUTER SCIENCE ANDENGINEERING,106,70,-36
2741,"P A College of Engineering and Technology(Autonomous), Palladam Road, Pollachi, CoimbatoreDt.-642002.",EC,ELECTRONICS ANDCOMMUNICATIONENGINEERING,70,71,1
2741,"P A College of Engineering and Technology(Autonomous), Palladam Road, Pollachi, CoimbatoreDt.-642002.",EE,ELECTRICAL AND ELECTRONICSENGINEERING,41,35,-6
2741,"P A College of Engineering and Technology(Autonomous), Palladam Road, Pollachi, CoimbatoreDt.-642002.",IT,INFORMATION TECHNOLOGY,34,35,1
2741,"P A College of Engineering and Technology(Autonomous), Palladam Road, Pollachi, CoimbatoreDt.-642002.",ME,MECHANICAL ENGINEERING,41,45,4
2743,"Dhanalakshmi Srinivasan College of Engineering(CBE), NH-47, Palakkad Main Road, Navakkarai Post,Coimbatore-641105.",AD,Artificial Intelligence and DataScience,81,109,28
2743,"Dhanalakshmi Srinivasan College of Engineering(CBE), NH-47, Palakkad Main Road, Navakkarai Post,Coimbatore-641105.",AG,AGRICULTURE ENGINEERING,23,17,-6
2743,"Dhanalakshmi Srinivasan College of Engineering(CBE), NH-47, Palakkad Main Road, Navakkarai Post,Coimbatore-641105.",BM,BIO MEDICAL ENGINEERING,27,55,28
2743,"Dhanalakshmi Srinivasan College of Engineering(CBE), NH-47, Palakkad Main Road, Navakkarai Post,Coimbatore-641105.",CE,CIVIL  ENGINEERING,14,18,4
2743,"Dhanalakshmi Srinivasan College of Engineering(CBE), NH-47, Palakkad Main Road, Navakkarai Post,Coimbatore-641105.",CS,COMPUTER SCIENCE ANDENGINEERING,67,109,42
2743,"Dhanalakshmi Srinivasan College of Engineering(CBE), NH-47, Palakkad Main Road, Navakkarai Post,Coimbatore-641105.",EC,ELECTRONICS ANDCOMMUNICATIONENGINEERING,67,82,15
2743,"Dhanalakshmi Srinivasan College of Engineering(CBE), NH-47, Palakkad Main Road, Navakkarai Post,Coimbatore-641105.",EE,ELECTRICAL AND ELECTRONICSENGINEERING,41,41,0
2743,"Dhanalakshmi Srinivasan College of Engineering(CBE), NH-47, Palakkad Main Road, Navakkarai Post,Coimbatore-641105.",FD,FOOD TECHNOLOGY,27,27,0
2743,"Dhanalakshmi Srinivasan College of Engineering(CBE), NH-47, Palakkad Main Road, Navakkarai Post,Coimbatore-641105.",ME,MECHANICAL ENGINEERING,14,27,13
2743,"Dhanalakshmi Srinivasan College of Engineering(CBE), NH-47, Palakkad Main Road, Navakkarai Post,Coimbatore-641105.",SC,Computer Science andEngineering (Cyber Security),27,27,0
2744,"Adithya Institute of Technology (Autonomous),S.F.No. 348/1,349/1, Kurumbapalayam, SSKulam(PO), Coimbatore-641107.",AD,Artificial Intelligence and DataScience,36,36,0
2744,"Adithya Institute of Technology (Autonomous),S.F.No. 348/1,349/1, Kurumbapalayam, SSKulam(PO), Coimbatore-641107.",CE,CIVIL  ENGINEERING,28,27,-1
2744,"Adithya Institute of Technology (Autonomous),S.F.No. 348/1,349/1, Kurumbapalayam, SSKulam(PO), Coimbatore-641107.",CS,COMPUTER SCIENCE ANDENGINEERING,35,36,1
2744,"Adithya Institute of Technology (Autonomous),S.F.No. 348/1,349/1, Kurumbapalayam, SSKulam(PO), Coimbatore-641107.",EC,ELECTRONICS ANDCOMMUNICATIONENGINEERING,35,36,1
2744,"Adithya Institute of Technology (Autonomous),S.F.No. 348/1,349/1, Kurumbapalayam, SSKulam(PO), Coimbatore-641107.",EE,ELECTRICAL AND ELECTRONICSENGINEERING,25,17,-8
2744,"Adithya Institute of Technology (Autonomous),S.F.No. 348/1,349/1, Kurumbapalayam, SSKulam(PO), Coimbatore-641107.",IT,INFORMATION TECHNOLOGY,34,36,2
2744,"Adithya Institute of Technology (Autonomous),S.F.No. 348/1,349/1, Kurumbapalayam, SSKulam(PO), Coimbatore-641107.",ME,MECHANICAL ENGINEERING,50,49,-1
2745,"Kathir College of Engineering (Autonomous),WISDOM TREE, Avinashi Road, Neelambur,Coimbatore-641062.",AD,Artificial Intelligence and DataScience,35,35,0
2745,"Kathir College of Engineering (Autonomous),WISDOM TREE, Avinashi Road, Neelambur,Coimbatore-641062.",AM,COMPUTER SCIENCE ANDENGINEERING (AI ANDMACHINE LEARNING),0,44,44
2745,"Kathir College of Engineering (Autonomous),WISDOM TREE, Avinashi Road, Neelambur,Coimbatore-641062.",CO,COMPUTER ANDCOMMUNICATIONENGINEERING,18,23,5
2745,"Kathir College of Engineering (Autonomous),WISDOM TREE, Avinashi Road, Neelambur,Coimbatore-641062.",CS,COMPUTER SCIENCE ANDENGINEERING,33,36,3
2745,"Kathir College of Engineering (Autonomous),WISDOM TREE, Avinashi Road, Neelambur,Coimbatore-641062.",EC,ELECTRONICS ANDCOMMUNICATIONENGINEERING,44,35,-9
2745,"Kathir College of Engineering (Autonomous),WISDOM TREE, Avinashi Road, Neelambur,Coimbatore-641062.",EE,ELECTRICAL AND ELECTRONICSENGINEERING,45,49,4
2745,"Kathir College of Engineering (Autonomous),WISDOM TREE, Avinashi Road, Neelambur,Coimbatore-641062.",ME,MECHANICAL ENGINEERING,24,23,-1
2747,"Shree Venkateshwara Hi-Tech Engineering College(Autonomous), Erode-Sathy Main Road,Sri KalaivaniNagar, Othakuthirai,K, Mettupalayam (Po),Gobichettipalayam (Tk), Erode (Dt)-638455.",AD,Artificial Intelligence and DataScience,45,37,-8
2747,"Shree Venkateshwara Hi-Tech Engineering College(Autonomous), Erode-Sathy Main Road,Sri KalaivaniNagar, Othakuthirai,K, Mettupalayam (Po),Gobichettipalayam (Tk), Erode (Dt)-638455.",AM,COMPUTER SCIENCE ANDENGINEERING (AI ANDMACHINE LEARNING),0,46,46
2747,"Shree Venkateshwara Hi-Tech Engineering College(Autonomous), Erode-Sathy Main Road,Sri KalaivaniNagar, Othakuthirai,K, Mettupalayam (Po),Gobichettipalayam (Tk), Erode (Dt)-638455.",BM,BIO MEDICAL ENGINEERING,44,45,1
2747,"Shree Venkateshwara Hi-Tech Engineering College(Autonomous), Erode-Sathy Main Road,Sri KalaivaniNagar, Othakuthirai,K, Mettupalayam (Po),Gobichettipalayam (Tk), Erode (Dt)-638455.",BT,BIO TECHNOLOGY,0,45,45
2747,"Shree Venkateshwara Hi-Tech Engineering College(Autonomous), Erode-Sathy Main Road,Sri KalaivaniNagar, Othakuthirai,K, Mettupalayam (Po),Gobichettipalayam (Tk), Erode (Dt)-638455.",CE,CIVIL  ENGINEERING,27,24,-3
2747,"Shree Venkateshwara Hi-Tech Engineering College(Autonomous), Erode-Sathy Main Road,Sri KalaivaniNagar, Othakuthirai,K, Mettupalayam (Po),Gobichettipalayam (Tk), Erode (Dt)-638455.",CS,COMPUTER SCIENCE ANDENGINEERING,88,99,11
2747,"Shree Venkateshwara Hi-Tech Engineering College(Autonomous), Erode-Sathy Main Road,Sri KalaivaniNagar, Othakuthirai,K, Mettupalayam (Po),Gobichettipalayam (Tk), Erode (Dt)-638455.",EC,ELECTRONICS ANDCOMMUNICATIONENGINEERING,44,46,2
2747,"Shree Venkateshwara Hi-Tech Engineering College(Autonomous), Erode-Sathy Main Road,Sri KalaivaniNagar, Othakuthirai,K, Mettupalayam (Po),Gobichettipalayam (Tk), Erode (Dt)-638455.",EE,ELECTRICAL AND ELECTRONICSENGINEERING,44,45,1
2747,"Shree Venkateshwara Hi-Tech Engineering College(Autonomous), Erode-Sathy Main Road,Sri KalaivaniNagar, Othakuthirai,K, Mettupalayam (Po),Gobichettipalayam (Tk), Erode (Dt)-638455.",IT,INFORMATION TECHNOLOGY,44,45,1
2747,"Shree Venkateshwara Hi-Tech Engineering College(Autonomous), Erode-Sathy Main Road,Sri KalaivaniNagar, Othakuthirai,K, Mettupalayam (Po),Gobichettipalayam (Tk), Erode (Dt)-638455.",ME,MECHANICAL ENGINEERING,55,45,-10
2747,"Shree Venkateshwara Hi-Tech Engineering College(Autonomous), Erode-Sathy Main Road,Sri KalaivaniNagar, Othakuthirai,K, Mettupalayam (Po),Gobichettipalayam (Tk), Erode (Dt)-638455.",PH,PHARMACEUTICALTECHNOLOGY,55,45,-10
2747,"Shree Venkateshwara Hi-Tech Engineering College(Autonomous), Erode-Sathy Main Road,Sri KalaivaniNagar, Othakuthirai,K, Mettupalayam (Po),Gobichettipalayam (Tk), Erode (Dt)-638455.",SC,Computer Science andEngineering (Cyber Security),0,45,45
2748,"Surya Engineering College, PerunduraiRoad,Manalmedu, Mettukadai,Kathirampatti Post,Erode-638107.",AD,Artificial Intelligence and DataScience,27,27,0
2748,"Surya Engineering College, PerunduraiRoad,Manalmedu, Mettukadai,Kathirampatti Post,Erode-638107.",AM,COMPUTER SCIENCE ANDENGINEERING (AI ANDMACHINE LEARNING),0,27,27
2748,"Surya Engineering College, PerunduraiRoad,Manalmedu, Mettukadai,Kathirampatti Post,Erode-638107.",BM,BIO MEDICAL ENGINEERING,27,27,0
2748,"Surya Engineering College, PerunduraiRoad,Manalmedu, Mettukadai,Kathirampatti Post,Erode-638107.",CE,CIVIL  ENGINEERING,27,27,0
2748,"Surya Engineering College, PerunduraiRoad,Manalmedu, Mettukadai,Kathirampatti Post,Erode-638107.",CS,COMPUTER SCIENCE ANDENGINEERING,55,53,-2
2748,"Surya Engineering College, PerunduraiRoad,Manalmedu, Mettukadai,Kathirampatti Post,Erode-638107.",EC,ELECTRONICS ANDCOMMUNICATIONENGINEERING,54,53,-1
2748,"Surya Engineering College, PerunduraiRoad,Manalmedu, Mettukadai,Kathirampatti Post,Erode-638107.",EE,ELECTRICAL AND ELECTRONICSENGINEERING,27,28,1
2748,"Surya Engineering College, PerunduraiRoad,Manalmedu, Mettukadai,Kathirampatti Post,Erode-638107.",IT,INFORMATION TECHNOLOGY,28,28,0
2748,"Surya Engineering College, PerunduraiRoad,Manalmedu, Mettukadai,Kathirampatti Post,Erode-638107.",ME,MECHANICAL ENGINEERING,55,28,-27
2748,"Surya Engineering College, PerunduraiRoad,Manalmedu, Mettukadai,Kathirampatti Post,Erode-638107.",SC,Computer Science andEngineering (Cyber Security),26,28,2
2749,"Easa College of Engineering and Technology, NH-47,Palakkad main Road, Navakkarai Post, Coimbatore-641105.",AD,Artificial Intelligence and DataScience,36,55,19
2749,"Easa College of Engineering and Technology, NH-47,Palakkad main Road, Navakkarai Post, Coimbatore-641105.",AG,AGRICULTURE ENGINEERING,35,55,20
2749,"Easa College of Engineering and Technology, NH-47,Palakkad main Road, Navakkarai Post, Coimbatore-641105.",AM,COMPUTER SCIENCE ANDENGINEERING (AI ANDMACHINE LEARNING),0,54,54
2749,"Easa College of Engineering and Technology, NH-47,Palakkad main Road, Navakkarai Post, Coimbatore-641105.",BM,BIO MEDICAL ENGINEERING,0,55,55
2749,"Easa College of Engineering and Technology, NH-47,Palakkad main Road, Navakkarai Post, Coimbatore-641105.",CS,COMPUTER SCIENCE ANDENGINEERING,34,55,21
2749,"Easa College of Engineering and Technology, NH-47,Palakkad main Road, Navakkarai Post, Coimbatore-641105.",EC,ELECTRONICS ANDCOMMUNICATIONENGINEERING,35,54,19
2749,"Easa College of Engineering and Technology, NH-47,Palakkad main Road, Navakkarai Post, Coimbatore-641105.",EE,ELECTRICAL AND ELECTRONICSENGINEERING,0,54,54
2749,"Easa College of Engineering and Technology, NH-47,Palakkad main Road, Navakkarai Post, Coimbatore-641105.",IT,INFORMATION TECHNOLOGY,36,54,18
2749,"Easa College of Engineering and Technology, NH-47,Palakkad main Road, Navakkarai Post, Coimbatore-641105.",ME,MECHANICAL ENGINEERING,36,54,18
2749,"Easa College of Engineering and Technology, NH-47,Palakkad main Road, Navakkarai Post, Coimbatore-641105.",SC,Computer Science andEngineering (Cyber Security),35,54,19
2750,"KIT - Kalaignarkarunanidhi Institute of Technology(Autonomous), S.F.No. 282,S.F.No. 283Kannampalayam Post, Coimbatore-641402.",AD,Artificial Intelligence and DataScience,35,106,71
2750,"KIT - Kalaignarkarunanidhi Institute of Technology(Autonomous), S.F.No. 282,S.F.No. 283Kannampalayam Post, Coimbatore-641402.",AE,AERONAUTICAL ENGINEERING,35,35,0
2750,"KIT - Kalaignarkarunanidhi Institute of Technology(Autonomous), S.F.No. 282,S.F.No. 283Kannampalayam Post, Coimbatore-641402.",AG,AGRICULTURE ENGINEERING,35,18,-17
2750,"KIT - Kalaignarkarunanidhi Institute of Technology(Autonomous), S.F.No. 282,S.F.No. 283Kannampalayam Post, Coimbatore-641402.",AM,COMPUTER SCIENCE ANDENGINEERING (AI ANDMACHINE LEARNING),35,36,1
2750,"KIT - Kalaignarkarunanidhi Institute of Technology(Autonomous), S.F.No. 282,S.F.No. 283Kannampalayam Post, Coimbatore-641402.",BM,BIO MEDICAL ENGINEERING,36,36,0
2750,"KIT - Kalaignarkarunanidhi Institute of Technology(Autonomous), S.F.No. 282,S.F.No. 283Kannampalayam Post, Coimbatore-641402.",BT,BIO TECHNOLOGY,35,36,1
2750,"KIT - Kalaignarkarunanidhi Institute of Technology(Autonomous), S.F.No. 282,S.F.No. 283Kannampalayam Post, Coimbatore-641402.",CB,COMPUTER SCIENCE ANDBUSSINESS SYSTEM,36,35,-1
2750,"KIT - Kalaignarkarunanidhi Institute of Technology(Autonomous), S.F.No. 282,S.F.No. 283Kannampalayam Post, Coimbatore-641402.",CS,COMPUTER SCIENCE ANDENGINEERING,35,105,70
2750,"KIT - Kalaignarkarunanidhi Institute of Technology(Autonomous), S.F.No. 282,S.F.No. 283Kannampalayam Post, Coimbatore-641402.",EC,ELECTRONICS ANDCOMMUNICATIONENGINEERING,71,70,-1
2750,"KIT - Kalaignarkarunanidhi Institute of Technology(Autonomous), S.F.No. 282,S.F.No. 283Kannampalayam Post, Coimbatore-641402.",EE,ELECTRICAL AND ELECTRONICSENGINEERING,35,35,0
2750,"KIT - Kalaignarkarunanidhi Institute of Technology(Autonomous), S.F.No. 282,S.F.No. 283Kannampalayam Post, Coimbatore-641402.",EV,Electronics Engineering (VLSIDesign and Technology),0,36,36
2750,"KIT - Kalaignarkarunanidhi Institute of Technology(Autonomous), S.F.No. 282,S.F.No. 283Kannampalayam Post, Coimbatore-641402.",ME,MECHANICAL ENGINEERING,34,35,1
2751,"KGISL Institute of Technology, 365, KGISL Campus,Thudiyalur Road, Saravanampatti, Coimbatore-641035.",AD,Artificial Intelligence and DataScience,70,70,0
2751,"KGISL Institute of Technology, 365, KGISL Campus,Thudiyalur Road, Saravanampatti, Coimbatore-641035.",AM,COMPUTER SCIENCE ANDENGINEERING (AI ANDMACHINE LEARNING),0,36,36
2751,"KGISL Institute of Technology, 365, KGISL Campus,Thudiyalur Road, Saravanampatti, Coimbatore-641035.",CB,COMPUTER SCIENCE ANDBUSSINESS SYSTEM,36,36,0
2751,"KGISL Institute of Technology, 365, KGISL Campus,Thudiyalur Road, Saravanampatti, Coimbatore-641035.",CS,COMPUTER SCIENCE ANDENGINEERING,70,70,0
2751,"KGISL Institute of Technology, 365, KGISL Campus,Thudiyalur Road, Saravanampatti, Coimbatore-641035.",EC,ELECTRONICS ANDCOMMUNICATIONENGINEERING,71,70,-1
2751,"KGISL Institute of Technology, 365, KGISL Campus,Thudiyalur Road, Saravanampatti, Coimbatore-641035.",IT,INFORMATION TECHNOLOGY,34,35,1
2751,"KGISL Institute of Technology, 365, KGISL Campus,Thudiyalur Road, Saravanampatti, Coimbatore-641035.",ME,MECHANICAL ENGINEERING,35,35,0
2751,"KGISL Institute of Technology, 365, KGISL Campus,Thudiyalur Road, Saravanampatti, Coimbatore-641035.",SC,Computer Science andEngineering (Cyber Security),0,36,36
2752,"Nandha College of Technology, 235,Chennimalaipalayam Road, Pitchandampalayam Post,Veppampalayam Village, Erode-638052.",CS,COMPUTER SCIENCE ANDENGINEERING,80,80,0
2752,"Nandha College of Technology, 235,Chennimalaipalayam Road, Pitchandampalayam Post,Veppampalayam Village, Erode-638052.",EC,ELECTRONICS ANDCOMMUNICATIONENGINEERING,35,36,1
2752,"Nandha College of Technology, 235,Chennimalaipalayam Road, Pitchandampalayam Post,Veppampalayam Village, Erode-638052.",EE,ELECTRICAL AND ELECTRONICSENGINEERING,54,49,-5
2752,"Nandha College of Technology, 235,Chennimalaipalayam Road, Pitchandampalayam Post,Veppampalayam Village, Erode-638052.",IT,INFORMATION TECHNOLOGY,89,94,5
2753,"PPG Institute of Technology, Rathnagiri Road,Saravanampatti, Coimbatore-641035.",AD,Artificial Intelligence and DataScience,17,36,19
2753,"PPG Institute of Technology, Rathnagiri Road,Saravanampatti, Coimbatore-641035.",AG,AGRICULTURE ENGINEERING,18,27,9
2753,"PPG Institute of Technology, Rathnagiri Road,Saravanampatti, Coimbatore-641035.",AM,COMPUTER SCIENCE ANDENGINEERING (AI ANDMACHINE LEARNING),18,26,8
2753,"PPG Institute of Technology, Rathnagiri Road,Saravanampatti, Coimbatore-641035.",BM,BIO MEDICAL ENGINEERING,17,51,34
2753,"PPG Institute of Technology, Rathnagiri Road,Saravanampatti, Coimbatore-641035.",CS,COMPUTER SCIENCE ANDENGINEERING,53,72,19
2753,"PPG Institute of Technology, Rathnagiri Road,Saravanampatti, Coimbatore-641035.",EC,ELECTRONICS ANDCOMMUNICATIONENGINEERING,17,26,9
2753,"PPG Institute of Technology, Rathnagiri Road,Saravanampatti, Coimbatore-641035.",IT,INFORMATION TECHNOLOGY,54,73,19
2753,"PPG Institute of Technology, Rathnagiri Road,Saravanampatti, Coimbatore-641035.",ME,MECHANICAL ENGINEERING,17,27,10
2755,"Nehru Institute of Technology (Autonomous),Jawahar Gardens, Kaliapuram,Thirumalayampalayam, Coimbatore-641105.",AE,AERONAUTICAL ENGINEERING,34,35,1
2755,"Nehru Institute of Technology (Autonomous),Jawahar Gardens, Kaliapuram,Thirumalayampalayam, Coimbatore-641105.",AG,AGRICULTURE ENGINEERING,35,18,-17
2755,"Nehru Institute of Technology (Autonomous),Jawahar Gardens, Kaliapuram,Thirumalayampalayam, Coimbatore-641105.",AM,COMPUTER SCIENCE ANDENGINEERING (AI ANDMACHINE LEARNING),0,35,35
2755,"Nehru Institute of Technology (Autonomous),Jawahar Gardens, Kaliapuram,Thirumalayampalayam, Coimbatore-641105.",CE,CIVIL  ENGINEERING,18,18,0
2755,"Nehru Institute of Technology (Autonomous),Jawahar Gardens, Kaliapuram,Thirumalayampalayam, Coimbatore-641105.",CS,COMPUTER SCIENCE ANDENGINEERING,54,71,17
2755,"Nehru Institute of Technology (Autonomous),Jawahar Gardens, Kaliapuram,Thirumalayampalayam, Coimbatore-641105.",FD,FOOD TECHNOLOGY,34,35,1
2755,"Nehru Institute of Technology (Autonomous),Jawahar Gardens, Kaliapuram,Thirumalayampalayam, Coimbatore-641105.",IT,INFORMATION TECHNOLOGY,35,36,1
2755,"Nehru Institute of Technology (Autonomous),Jawahar Gardens, Kaliapuram,Thirumalayampalayam, Coimbatore-641105.",SC,Computer Science andEngineering (Cyber Security),0,35,35
2758,"JKK Munirajah College of Technology (Autonomous),377/1A, Punjai Thurayampalayam,Thookkanickenpalayam (Post),Thookkanickenpalayam, Gobi (Tk), Erode-638506.",AD,Artificial Intelligence and DataScience,35,78,43
2758,"JKK Munirajah College of Technology (Autonomous),377/1A, Punjai Thurayampalayam,Thookkanickenpalayam (Post),Thookkanickenpalayam, Gobi (Tk), Erode-638506.",AU,AUTOMOBILE ENGINEERING,17,27,10
2758,"JKK Munirajah College of Technology (Autonomous),377/1A, Punjai Thurayampalayam,Thookkanickenpalayam (Post),Thookkanickenpalayam, Gobi (Tk), Erode-638506.",CE,CIVIL  ENGINEERING,17,27,10
2758,"JKK Munirajah College of Technology (Autonomous),377/1A, Punjai Thurayampalayam,Thookkanickenpalayam (Post),Thookkanickenpalayam, Gobi (Tk), Erode-638506.",CS,COMPUTER SCIENCE ANDENGINEERING,35,77,42
2758,"JKK Munirajah College of Technology (Autonomous),377/1A, Punjai Thurayampalayam,Thookkanickenpalayam (Post),Thookkanickenpalayam, Gobi (Tk), Erode-638506.",EC,ELECTRONICS ANDCOMMUNICATIONENGINEERING,18,50,32
2758,"JKK Munirajah College of Technology (Autonomous),377/1A, Punjai Thurayampalayam,Thookkanickenpalayam (Post),Thookkanickenpalayam, Gobi (Tk), Erode-638506.",EE,ELECTRICAL AND ELECTRONICSENGINEERING,18,50,32
2758,"JKK Munirajah College of Technology (Autonomous),377/1A, Punjai Thurayampalayam,Thookkanickenpalayam (Post),Thookkanickenpalayam, Gobi (Tk), Erode-638506.",IT,INFORMATION TECHNOLOGY,35,77,42
2758,"JKK Munirajah College of Technology (Autonomous),377/1A, Punjai Thurayampalayam,Thookkanickenpalayam (Post),Thookkanickenpalayam, Gobi (Tk), Erode-638506.",ME,MECHANICAL ENGINEERING,18,28,10
2758,"JKK Munirajah College of Technology (Autonomous),377/1A, Punjai Thurayampalayam,Thookkanickenpalayam (Post),Thookkanickenpalayam, Gobi (Tk), Erode-638506.",SC,Computer Science andEngineering (Cyber Security),18,50,32
2761,"United Institute of Technology (Autonomous),G.Koundampalayam, Periyanaickenpalayam,Coimbatore-641020.",AD,Artificial Intelligence and DataScience,35,36,1
2761,"United Institute of Technology (Autonomous),G.Koundampalayam, Periyanaickenpalayam,Coimbatore-641020.",CS,COMPUTER SCIENCE ANDENGINEERING,35,36,1
2761,"United Institute of Technology (Autonomous),G.Koundampalayam, Periyanaickenpalayam,Coimbatore-641020.",EC,ELECTRONICS ANDCOMMUNICATIONENGINEERING,55,54,-1
2761,"United Institute of Technology (Autonomous),G.Koundampalayam, Periyanaickenpalayam,Coimbatore-641020.",IT,INFORMATION TECHNOLOGY,18,54,36
2761,"United Institute of Technology (Autonomous),G.Koundampalayam, Periyanaickenpalayam,Coimbatore-641020.",RM,ROBOTICS AND AUTOMATION,27,28,1
2761,"United Institute of Technology (Autonomous),G.Koundampalayam, Periyanaickenpalayam,Coimbatore-641020.",SC,Computer Science andEngineering (Cyber Security),54,53,-1
2762,"Jansons Institute of Technology (Autonomous),SF.NO.443/1,2, 442/1A & 442/1B Karumathampatty,Coimbatore-641659.",AD,Artificial Intelligence and DataScience,34,70,36
2762,"Jansons Institute of Technology (Autonomous),SF.NO.443/1,2, 442/1A & 442/1B Karumathampatty,Coimbatore-641659.",CB,COMPUTER SCIENCE ANDBUSSINESS SYSTEM,35,45,10
2762,"Jansons Institute of Technology (Autonomous),SF.NO.443/1,2, 442/1A & 442/1B Karumathampatty,Coimbatore-641659.",CE,CIVIL  ENGINEERING,18,19,1
2762,"Jansons Institute of Technology (Autonomous),SF.NO.443/1,2, 442/1A & 442/1B Karumathampatty,Coimbatore-641659.",CS,COMPUTER SCIENCE ANDENGINEERING,53,71,18
2762,"Jansons Institute of Technology (Autonomous),SF.NO.443/1,2, 442/1A & 442/1B Karumathampatty,Coimbatore-641659.",EC,ELECTRONICS ANDCOMMUNICATIONENGINEERING,53,91,38
2762,"Jansons Institute of Technology (Autonomous),SF.NO.443/1,2, 442/1A & 442/1B Karumathampatty,Coimbatore-641659.",ME,MECHANICAL ENGINEERING,27,27,0
2763,"Akshaya College of Engineering and Technology, SFNo.112/1CPT,114/1,115/1,116/2C, BagavathipalayamRoad,Kinathukadavu, Coimbatore-642109.",AD,Artificial Intelligence and DataScience,35,36,1
2763,"Akshaya College of Engineering and Technology, SFNo.112/1CPT,114/1,115/1,116/2C, BagavathipalayamRoad,Kinathukadavu, Coimbatore-642109.",CB,COMPUTER SCIENCE ANDBUSSINESS SYSTEM,19,19,0
2763,"Akshaya College of Engineering and Technology, SFNo.112/1CPT,114/1,115/1,116/2C, BagavathipalayamRoad,Kinathukadavu, Coimbatore-642109.",CE,CIVIL  ENGINEERING,22,23,1
2763,"Akshaya College of Engineering and Technology, SFNo.112/1CPT,114/1,115/1,116/2C, BagavathipalayamRoad,Kinathukadavu, Coimbatore-642109.",CS,COMPUTER SCIENCE ANDENGINEERING,54,51,-3
2763,"Akshaya College of Engineering and Technology, SFNo.112/1CPT,114/1,115/1,116/2C, BagavathipalayamRoad,Kinathukadavu, Coimbatore-642109.",EC,ELECTRONICS ANDCOMMUNICATIONENGINEERING,34,36,2
2763,"Akshaya College of Engineering and Technology, SFNo.112/1CPT,114/1,115/1,116/2C, BagavathipalayamRoad,Kinathukadavu, Coimbatore-642109.",EE,ELECTRICAL AND ELECTRONICSENGINEERING,23,23,0
2763,"Akshaya College of Engineering and Technology, SFNo.112/1CPT,114/1,115/1,116/2C, BagavathipalayamRoad,Kinathukadavu, Coimbatore-642109.",ME,MECHANICAL ENGINEERING,23,24,1
2763,"Akshaya College of Engineering and Technology, SFNo.112/1CPT,114/1,115/1,116/2C, BagavathipalayamRoad,Kinathukadavu, Coimbatore-642109.",MZ,Mechatronics Engineering,22,24,2
2764,"KPR Institute of Engineering and Technology(Autonomous), SF:204/2 & 204/4, KollupalayamVillage, Arasur Panchayat, Coimbatore-641407.",AD,Artificial Intelligence and DataScience,35,71,36
2764,"KPR Institute of Engineering and Technology(Autonomous), SF:204/2 & 204/4, KollupalayamVillage, Arasur Panchayat, Coimbatore-641407.",AM,COMPUTER SCIENCE ANDENGINEERING (AI ANDMACHINE LEARNING),34,36,2
2764,"KPR Institute of Engineering and Technology(Autonomous), SF:204/2 & 204/4, KollupalayamVillage, Arasur Panchayat, Coimbatore-641407.",BM,BIO MEDICAL ENGINEERING,35,36,1
2764,"KPR Institute of Engineering and Technology(Autonomous), SF:204/2 & 204/4, KollupalayamVillage, Arasur Panchayat, Coimbatore-641407.",CB,COMPUTER SCIENCE ANDBUSSINESS SYSTEM,36,35,-1
2764,"KPR Institute of Engineering and Technology(Autonomous), SF:204/2 & 204/4, KollupalayamVillage, Arasur Panchayat, Coimbatore-641407.",CE,CIVIL  ENGINEERING,35,35,0
2764,"KPR Institute of Engineering and Technology(Autonomous), SF:204/2 & 204/4, KollupalayamVillage, Arasur Panchayat, Coimbatore-641407.",CH,CHEMICAL  ENGINEERING,35,35,0
2764,"KPR Institute of Engineering and Technology(Autonomous), SF:204/2 & 204/4, KollupalayamVillage, Arasur Panchayat, Coimbatore-641407.",CS,COMPUTER SCIENCE ANDENGINEERING,107,141,34
2764,"KPR Institute of Engineering and Technology(Autonomous), SF:204/2 & 204/4, KollupalayamVillage, Arasur Panchayat, Coimbatore-641407.",EC,ELECTRONICS ANDCOMMUNICATIONENGINEERING,71,106,35
2764,"KPR Institute of Engineering and Technology(Autonomous), SF:204/2 & 204/4, KollupalayamVillage, Arasur Panchayat, Coimbatore-641407.",EE,ELECTRICAL AND ELECTRONICSENGINEERING,35,35,0
2764,"KPR Institute of Engineering and Technology(Autonomous), SF:204/2 & 204/4, KollupalayamVillage, Arasur Panchayat, Coimbatore-641407.",IT,INFORMATION TECHNOLOGY,35,70,35
2764,"KPR Institute of Engineering and Technology(Autonomous), SF:204/2 & 204/4, KollupalayamVillage, Arasur Panchayat, Coimbatore-641407.",ME,MECHANICAL ENGINEERING,35,36,1
2764,"KPR Institute of Engineering and Technology(Autonomous), SF:204/2 & 204/4, KollupalayamVillage, Arasur Panchayat, Coimbatore-641407.",MZ,Mechatronics Engineering,35,36,1
2767,"SRG Engineering College, SH-95,Mohanur Road,Aniyapuram, Namakkal-637017.",AD,Artificial Intelligence and DataScience,18,17,-1
2767,"SRG Engineering College, SH-95,Mohanur Road,Aniyapuram, Namakkal-637017.",BM,BIO MEDICAL ENGINEERING,35,35,0
2767,"SRG Engineering College, SH-95,Mohanur Road,Aniyapuram, Namakkal-637017.",CE,CIVIL  ENGINEERING,18,18,0
2767,"SRG Engineering College, SH-95,Mohanur Road,Aniyapuram, Namakkal-637017.",CS,COMPUTER SCIENCE ANDENGINEERING,35,36,1
2767,"SRG Engineering College, SH-95,Mohanur Road,Aniyapuram, Namakkal-637017.",EE,ELECTRICAL AND ELECTRONICSENGINEERING,35,35,0
2767,"SRG Engineering College, SH-95,Mohanur Road,Aniyapuram, Namakkal-637017.",IT,INFORMATION TECHNOLOGY,18,18,0
2767,"SRG Engineering College, SH-95,Mohanur Road,Aniyapuram, Namakkal-637017.",ME,MECHANICAL ENGINEERING,35,35,0
2767,"SRG Engineering College, SH-95,Mohanur Road,Aniyapuram, Namakkal-637017.",SC,Computer Science andEngineering (Cyber Security),18,18,0
2768,"Park College of Technology, Prema Ravi Nagar,Karumathampatty, Coimbatore-641659.",AD,Artificial Intelligence and DataScience,35,36,1
2768,"Park College of Technology, Prema Ravi Nagar,Karumathampatty, Coimbatore-641659.",AM,COMPUTER SCIENCE ANDENGINEERING (AI ANDMACHINE LEARNING),0,17,17
2768,"Park College of Technology, Prema Ravi Nagar,Karumathampatty, Coimbatore-641659.",AO,AEROSPACE ENGINEERING,19,18,-1
2768,"Park College of Technology, Prema Ravi Nagar,Karumathampatty, Coimbatore-641659.",CE,CIVIL  ENGINEERING,19,16,-3
2768,"Park College of Technology, Prema Ravi Nagar,Karumathampatty, Coimbatore-641659.",CS,COMPUTER SCIENCE ANDENGINEERING,34,36,2
2768,"Park College of Technology, Prema Ravi Nagar,Karumathampatty, Coimbatore-641659.",EC,ELECTRONICS ANDCOMMUNICATIONENGINEERING,19,18,-1
2768,"Park College of Technology, Prema Ravi Nagar,Karumathampatty, Coimbatore-641659.",EN,ENVIRONMENTALENGINEERING,18,18,0
2768,"Park College of Technology, Prema Ravi Nagar,Karumathampatty, Coimbatore-641659.",ME,MECHANICAL ENGINEERING,35,18,-17
2769,"JCT College of Engineering and Technology(Autonomous), Pichanur, Coimbatore South Taluk,Coimbatore-641105.",AD,Artificial Intelligence and DataScience,54,71,17
2769,"JCT College of Engineering and Technology(Autonomous), Pichanur, Coimbatore South Taluk,Coimbatore-641105.",BC,Bio Technology and BioChemical Engineering,35,35,0
2769,"JCT College of Engineering and Technology(Autonomous), Pichanur, Coimbatore South Taluk,Coimbatore-641105.",CB,COMPUTER SCIENCE ANDBUSSINESS SYSTEM,35,35,0
2769,"JCT College of Engineering and Technology(Autonomous), Pichanur, Coimbatore South Taluk,Coimbatore-641105.",CE,CIVIL  ENGINEERING,18,17,-1
2769,"JCT College of Engineering and Technology(Autonomous), Pichanur, Coimbatore South Taluk,Coimbatore-641105.",CS,COMPUTER SCIENCE ANDENGINEERING,70,106,36
2769,"JCT College of Engineering and Technology(Autonomous), Pichanur, Coimbatore South Taluk,Coimbatore-641105.",EC,ELECTRONICS ANDCOMMUNICATIONENGINEERING,35,36,1
2769,"JCT College of Engineering and Technology(Autonomous), Pichanur, Coimbatore South Taluk,Coimbatore-641105.",EE,ELECTRICAL AND ELECTRONICSENGINEERING,35,17,-18
2769,"JCT College of Engineering and Technology(Autonomous), Pichanur, Coimbatore South Taluk,Coimbatore-641105.",FD,FOOD TECHNOLOGY,35,35,0
2769,"JCT College of Engineering and Technology(Autonomous), Pichanur, Coimbatore South Taluk,Coimbatore-641105.",ME,MECHANICAL ENGINEERING,18,18,0
2769,"JCT College of Engineering and Technology(Autonomous), Pichanur, Coimbatore South Taluk,Coimbatore-641105.",PC,PETRO CHEMICALTECHNOLOGY,35,18,-17
2769,"JCT College of Engineering and Technology(Autonomous), Pichanur, Coimbatore South Taluk,Coimbatore-641105.",PE,PETROLEUM ENGINEERING,35,18,-17
2770,"Studyworld College of Engineering, AlaguNachiamman Koil Road, Palathurai Post, Coimbatore-641105.",AD,Artificial Intelligence and DataScience,35,51,16
2770,"Studyworld College of Engineering, AlaguNachiamman Koil Road, Palathurai Post, Coimbatore-641105.",AM,COMPUTER SCIENCE ANDENGINEERING (AI ANDMACHINE LEARNING),0,16,16
2770,"Studyworld College of Engineering, AlaguNachiamman Koil Road, Palathurai Post, Coimbatore-641105.",CS,COMPUTER SCIENCE ANDENGINEERING,70,72,2
2770,"Studyworld College of Engineering, AlaguNachiamman Koil Road, Palathurai Post, Coimbatore-641105.",EC,ELECTRONICS ANDCOMMUNICATIONENGINEERING,35,36,1
2770,"Studyworld College of Engineering, AlaguNachiamman Koil Road, Palathurai Post, Coimbatore-641105.",EE,ELECTRICAL AND ELECTRONICSENGINEERING,18,18,0
2770,"Studyworld College of Engineering, AlaguNachiamman Koil Road, Palathurai Post, Coimbatore-641105.",IT,INFORMATION TECHNOLOGY,18,19,1
2770,"Studyworld College of Engineering, AlaguNachiamman Koil Road, Palathurai Post, Coimbatore-641105.",ME,MECHANICAL ENGINEERING,35,18,-17
2770,"Studyworld College of Engineering, AlaguNachiamman Koil Road, Palathurai Post, Coimbatore-641105.",SC,Computer Science andEngineering (Cyber Security),0,18,18
2772,"C M S College of Engineering and Technology,Appachigoundapathy, Kumittipathy Post, Coimbatore-641032.",AD,Artificial Intelligence and DataScience,35,52,17
2772,"C M S College of Engineering and Technology,Appachigoundapathy, Kumittipathy Post, Coimbatore-641032.",AM,COMPUTER SCIENCE ANDENGINEERING (AI ANDMACHINE LEARNING),0,17,17
2772,C M S College of Engineering and TechnologyAppachigoundenpathy  Kumittipathi Post  CoimbatoreDistrict 641032,CB,COMPUTER SCIENCE ANDBUSSINESS SYSTEM,18,0,-18
2772,"C M S College of Engineering and Technology,Appachigoundapathy, Kumittipathy Post, Coimbatore-641032.",CS,COMPUTER SCIENCE ANDENGINEERING,35,35,0
2772,"C M S College of Engineering and Technology,Appachigoundapathy, Kumittipathy Post, Coimbatore-641032.",EC,ELECTRONICS ANDCOMMUNICATIONENGINEERING,50,45,-5
2772,"C M S College of Engineering and Technology,Appachigoundapathy, Kumittipathy Post, Coimbatore-641032.",IT,INFORMATION TECHNOLOGY,17,19,2
2772,"C M S College of Engineering and Technology,Appachigoundapathy, Kumittipathy Post, Coimbatore-641032.",ME,MECHANICAL ENGINEERING,18,18,0
2772,"C M S College of Engineering and Technology,Appachigoundapathy, Kumittipathy Post, Coimbatore-641032.",SC,Computer Science andEngineering (Cyber Security),17,18,1
2776,"R V S Technical Campus Coimbatore, KumaranKottam Campus, Kannampalayam, Sulur, Coimbatore-641402.",AD,Artificial Intelligence and DataScience,34,70,36
2776,"R V S Technical Campus Coimbatore, KumaranKottam Campus, Kannampalayam, Sulur, Coimbatore-641402.",AG,AGRICULTURE ENGINEERING,53,61,8
2776,"R V S Technical Campus Coimbatore, KumaranKottam Campus, Kannampalayam, Sulur, Coimbatore-641402.",AM,COMPUTER SCIENCE ANDENGINEERING (AI ANDMACHINE LEARNING),18,18,0
2776,"R V S Technical Campus Coimbatore, KumaranKottam Campus, Kannampalayam, Sulur, Coimbatore-641402.",AU,AUTOMOBILE ENGINEERING,18,23,5
2776,"R V S Technical Campus Coimbatore, KumaranKottam Campus, Kannampalayam, Sulur, Coimbatore-641402.",CE,CIVIL  ENGINEERING,17,23,6
2776,"R V S Technical Campus Coimbatore, KumaranKottam Campus, Kannampalayam, Sulur, Coimbatore-641402.",CS,COMPUTER SCIENCE ANDENGINEERING,35,37,2
2776,"R V S Technical Campus Coimbatore, KumaranKottam Campus, Kannampalayam, Sulur, Coimbatore-641402.",ME,MECHANICAL ENGINEERING,18,19,1
2776,"R V S Technical Campus Coimbatore, KumaranKottam Campus, Kannampalayam, Sulur, Coimbatore-641402.",MZ,Mechatronics Engineering,18,16,-2
2776,"R V S Technical Campus Coimbatore, KumaranKottam Campus, Kannampalayam, Sulur, Coimbatore-641402.",SC,Computer Science andEngineering (Cyber Security),0,35,35
3011,University College of Engineering  Tiruchirappalli(Bharathidasan Institute of Technology)Tiruchirappalli District 620024,AM,COMPUTER SCIENCE ANDENGINEERING (AI ANDMACHINE LEARNING),0,55,55
3011,University College of Engineering  Tiruchirappalli(Bharathidasan Institute of Technology)  TiruchirappalliDistrict 620024,AU,AUTOMOBILE ENGINEERING,54,0,-54
3011,University College of Engineering  Tiruchirappalli(Bharathidasan Institute of Technology)Tiruchirappalli District 620024,BT,BIO TECHNOLOGY,55,55,0
3011,University College of Engineering  Tiruchirappalli(Bharathidasan Institute of Technology)Tiruchirappalli District 620024,CE,CIVIL  ENGINEERING,108,53,-55
3011,University College of Engineering  Tiruchirappalli(Bharathidasan Institute of Technology)Tiruchirappalli District 620024,CF,COMPUTER SCIENCE ANDENGINEERING (DATA SCIENCE),0,55,55
3011,University College of Engineering  Tiruchirappalli(Bharathidasan Institute of Technology)Tiruchirappalli District 620024,CK,Civil Engineering(Environmental Engineering),0,55,55
3011,University College of Engineering  Tiruchirappalli(Bharathidasan Institute of Technology)Tiruchirappalli District 620024,CS,COMPUTER SCIENCE ANDENGINEERING,107,53,-54
3011,University College of Engineering  Tiruchirappalli(Bharathidasan Institute of Technology)Tiruchirappalli District 620024,EC,ELECTRONICS ANDCOMMUNICATIONENGINEERING,107,53,-54
3011,University College of Engineering  Tiruchirappalli(Bharathidasan Institute of Technology)Tiruchirappalli District 620024,EE,ELECTRICAL AND ELECTRONICSENGINEERING,109,53,-56
3011,University College of Engineering  Tiruchirappalli(Bharathidasan Institute of Technology)Tiruchirappalli District 620024,EF,Electrical and ComputerEngineering,0,55,55
3011,University College of Engineering  Tiruchirappalli(Bharathidasan Institute of Technology)Tiruchirappalli District 620024,EV,Electronics Engineering (VLSIDesign and Technology),0,55,55
3011,University College of Engineering  Tiruchirappalli(Bharathidasan Institute of Technology)Tiruchirappalli District 620024,IT,INFORMATION TECHNOLOGY,108,55,-53
3011,University College of Engineering  Tiruchirappalli(Bharathidasan Institute of Technology)Tiruchirappalli District 620024,MB,Mechanical Engineering(Automobile),0,55,55
3011,University College of Engineering  Tiruchirappalli(Bharathidasan Institute of Technology)Tiruchirappalli District 620024,ME,MECHANICAL ENGINEERING,108,55,-53
3011,University College of Engineering  Tiruchirappalli(Bharathidasan Institute of Technology)Tiruchirappalli District 620024,MJ,Mechanical and SmartManufacturing,0,54,54
3011,University College of Engineering  Tiruchirappalli(Bharathidasan Institute of Technology)Tiruchirappalli District 620024,PC,PETRO CHEMICALTECHNOLOGY,54,55,1
3011,University College of Engineering  Tiruchirappalli(Bharathidasan Institute of Technology)Tiruchirappalli District 620024,PH,PHARMACEUTICALTECHNOLOGY,55,55,0
3011,University College of Engineering  Tiruchirappalli(Bharathidasan Institute of Technology)Tiruchirappalli District 620024,XC,CIVIL ENGINEERING (TAMILMEDIUM),55,54,-1
3011,University College of Engineering  Tiruchirappalli(Bharathidasan Institute of Technology)Tiruchirappalli District 620024,XM,MECHANICAL ENGINEERING(TAMIL MEDIUM),55,54,-1
3016,University College of Engineering  AriyalurKathankudikadu Village  Thelur Post  Ariyalur District621704,CE,CIVIL  ENGINEERING,54,55,1
3016,University College of Engineering  AriyalurKathankudikadu Village  Thelur Post  Ariyalur District621704,CS,COMPUTER SCIENCE ANDENGINEERING,54,54,0
3016,University College of Engineering  AriyalurKathankudikadu Village  Thelur Post  Ariyalur District621704,EC,ELECTRONICS ANDCOMMUNICATIONENGINEERING,54,54,0
3016,University College of Engineering  AriyalurKathankudikadu Village  Thelur Post  Ariyalur District621704,EE,ELECTRICAL AND ELECTRONICSENGINEERING,55,55,0
3016,University College of Engineering  AriyalurKathankudikadu Village  Thelur Post  Ariyalur District621704,ME,MECHANICAL ENGINEERING,54,55,1
3016,University College of Engineering  AriyalurKathankudikadu Village  Thelur Post  Ariyalur District621704,XC,CIVIL ENGINEERING (TAMILMEDIUM),28,26,-2
3016,University College of Engineering  AriyalurKathankudikadu Village  Thelur Post  Ariyalur District621704,XM,MECHANICAL ENGINEERING(TAMIL MEDIUM),26,27,1
3018,University College of Engineering  ThirukkuvalaiNagappattinam District 610204,CE,CIVIL  ENGINEERING,55,54,-1
3018,University College of Engineering  ThirukkuvalaiNagappattinam District 610204,CS,COMPUTER SCIENCE ANDENGINEERING,54,55,1
3018,University College of Engineering  ThirukkuvalaiNagappattinam District 610204,EC,ELECTRONICS ANDCOMMUNICATIONENGINEERING,54,55,1
3018,University College of Engineering  ThirukkuvalaiNagappattinam District 610204,EE,ELECTRICAL AND ELECTRONICSENGINEERING,55,54,-1
3018,University College of Engineering  ThirukkuvalaiNagappattinam District 610204,ME,MECHANICAL ENGINEERING,55,54,-1
3018,University College of Engineering  ThirukkuvalaiNagappattinam District 610204,XC,CIVIL ENGINEERING (TAMILMEDIUM),26,27,1
3018,University College of Engineering  ThirukkuvalaiNagappattinam District 610204,XM,MECHANICAL ENGINEERING(TAMIL MEDIUM),27,27,0
3019,University College of Engineering  Panruti  Chennai-Kumbakonam Highway  Panikkankuppam  PanrutiCuddalore District 607106,CE,CIVIL  ENGINEERING,55,54,-1
3019,University College of Engineering  Panruti  Chennai-Kumbakonam Highway  Panikkankuppam  PanrutiCuddalore District 607106,CS,COMPUTER SCIENCE ANDENGINEERING,54,54,0
3019,University College of Engineering  Panruti  Chennai-Kumbakonam Highway  Panikkankuppam  PanrutiCuddalore District 607106,EC,ELECTRONICS ANDCOMMUNICATIONENGINEERING,55,55,0
3019,University College of Engineering  Panruti  Chennai-Kumbakonam Highway  Panikkankuppam  PanrutiCuddalore District 607106,EE,ELECTRICAL AND ELECTRONICSENGINEERING,55,55,0
3019,University College of Engineering  Panruti  Chennai-Kumbakonam Highway  Panikkankuppam  PanrutiCuddalore District 607106,ME,MECHANICAL ENGINEERING,53,55,2
3019,University College of Engineering  Panruti  Chennai-Kumbakonam Highway  Panikkankuppam  PanrutiCuddalore District 607106,XC,CIVIL ENGINEERING (TAMILMEDIUM),27,27,0
3019,University College of Engineering  Panruti  Chennai-Kumbakonam Highway  Panikkankuppam  PanrutiCuddalore District 607106,XM,MECHANICAL ENGINEERING(TAMIL MEDIUM),27,27,0
3021,University College of Engineering  Pattukkottai  ECRRoad  Rajamadam  Pattukkottai Taluk  ThanjavurDistrict 614701,CE,CIVIL  ENGINEERING,55,55,0
3021,University College of Engineering  Pattukkottai  ECRRoad  Rajamadam  Pattukkottai Taluk  ThanjavurDistrict 614701,CS,COMPUTER SCIENCE ANDENGINEERING,54,54,0
3021,University College of Engineering  Pattukkottai  ECRRoad  Rajamadam  Pattukkottai Taluk  ThanjavurDistrict 614701,EC,ELECTRONICS ANDCOMMUNICATIONENGINEERING,54,55,1
3021,University College of Engineering  Pattukkottai  ECRRoad  Rajamadam  Pattukkottai Taluk  ThanjavurDistrict 614701,EE,ELECTRICAL AND ELECTRONICSENGINEERING,55,27,-28
3021,University College of Engineering  Pattukkottai  ECRRoad  Rajamadam  Pattukkottai Taluk  ThanjavurDistrict 614701,ME,MECHANICAL ENGINEERING,54,27,-27
3021,University College of Engineering  Pattukkottai  ECRRoad  Rajamadam  Pattukkottai Taluk  ThanjavurDistrict 614701,XC,CIVIL ENGINEERING (TAMILMEDIUM),26,28,2
3021,University College of Engineering  Pattukkottai  ECRRoad  Rajamadam  Pattukkottai Taluk  ThanjavurDistrict 614701,XM,MECHANICAL ENGINEERING(TAMIL MEDIUM),28,26,-2
3403,Mahalakshmi Engineering College  Trichy-SalemHighways  (Near No.1 Tollgate)  Melpathu  SiruganburPost  Tiruchirappalli District 621213,AD,ARTIFICIAL INTELLIGENCEAND DATA SCIENCE,18,0,-18
3403,Mahalakshmi Engineering College  Trichy-SalemHighways  (Near No.1 Tollgate)  Melpathu  SiruganburPost  Tiruchirappalli District 621213,AG,AGRICULTURAL ENGINEERING,18,0,-18
3403,Mahalakshmi Engineering College  Trichy-SalemHighways  (Near No.1 Tollgate)  Melpathu  SiruganburPost  Tiruchirappalli District 621213,BC,Bio Technology and BioChemical Engineering,18,0,-18
3403,Mahalakshmi Engineering College  Trichy-SalemHighways  (Near No.1 Tollgate)  Melpathu  SiruganburPost  Tiruchirappalli District 621213,CE,CIVIL  ENGINEERING,17,0,-17
3403,Mahalakshmi Engineering College  Trichy-SalemHighways  (Near No.1 Tollgate)  Melpathu  SiruganburPost  Tiruchirappalli District 621213,CS,COMPUTER SCIENCE ANDENGINEERING,34,0,-34
3403,Mahalakshmi Engineering College  Trichy-SalemHighways  (Near No.1 Tollgate)  Melpathu  SiruganburPost  Tiruchirappalli District 621213,EC,ELECTRONICS ANDCOMMUNICATIONENGINEERING,18,0,-18
3403,Mahalakshmi Engineering College  Trichy-SalemHighways  (Near No.1 Tollgate)  Melpathu  SiruganburPost  Tiruchirappalli District 621213,EE,ELECTRICAL ANDELECTRONICS ENGINEERING,17,0,-17
3403,Mahalakshmi Engineering College  Trichy-SalemHighways  (Near No.1 Tollgate)  Melpathu  SiruganburPost  Tiruchirappalli District 621213,ME,MECHANICAL ENGINEERING,18,0,-18
3403,Mahalakshmi Engineering College  Trichy-SalemHighways  (Near No.1 Tollgate)  Melpathu  SiruganburPost  Tiruchirappalli District 621213,PH,PHARMACEUTICALTECHNOLOGY,18,0,-18
3410,"Krishnasamy College of Engineering and Technology,Nellikuppam Main Road, S.Kumarapuram, Cuddalore-607109.",AD,Artificial Intelligence and DataScience,0,41,41
3410,"Krishnasamy College of Engineering and Technology,Nellikuppam Main Road, S.Kumarapuram, Cuddalore-607109.",CE,CIVIL  ENGINEERING,22,23,1
3410,"Krishnasamy College of Engineering and Technology,Nellikuppam Main Road, S.Kumarapuram, Cuddalore-607109.",CS,COMPUTER SCIENCE ANDENGINEERING,41,41,0
3410,"Krishnasamy College of Engineering and Technology,Nellikuppam Main Road, S.Kumarapuram, Cuddalore-607109.",EC,ELECTRONICS ANDCOMMUNICATIONENGINEERING,45,45,0
3410,"Krishnasamy College of Engineering and Technology,Nellikuppam Main Road, S.Kumarapuram, Cuddalore-607109.",EE,ELECTRICAL AND ELECTRONICSENGINEERING,50,50,0
3410,"Krishnasamy College of Engineering and Technology,Nellikuppam Main Road, S.Kumarapuram, Cuddalore-607109.",IT,INFORMATION TECHNOLOGY,40,41,1
3410,"Krishnasamy College of Engineering and Technology,Nellikuppam Main Road, S.Kumarapuram, Cuddalore-607109.",ME,MECHANICAL ENGINEERING,50,50,0
3425,"C.K. College of Engineering & Technology, JayaramNagar, Chellangkuppam, Cuddalore-607003.",AD,Artificial Intelligence and DataScience,35,35,0
3425,"C.K. College of Engineering & Technology, JayaramNagar, Chellangkuppam, Cuddalore-607003.",BM,BIO MEDICAL ENGINEERING,0,26,26
3425,"C.K. College of Engineering & Technology, JayaramNagar, Chellangkuppam, Cuddalore-607003.",CE,CIVIL  ENGINEERING,28,26,-2
3425,"C.K. College of Engineering & Technology, JayaramNagar, Chellangkuppam, Cuddalore-607003.",CS,COMPUTER SCIENCE ANDENGINEERING,34,35,1
3425,"C.K. College of Engineering & Technology, JayaramNagar, Chellangkuppam, Cuddalore-607003.",EC,ELECTRONICS ANDCOMMUNICATIONENGINEERING,41,38,-3
3425,"C.K. College of Engineering & Technology, JayaramNagar, Chellangkuppam, Cuddalore-607003.",EE,ELECTRICAL AND ELECTRONICSENGINEERING,49,49,0
3425,"C.K. College of Engineering & Technology, JayaramNagar, Chellangkuppam, Cuddalore-607003.",IT,INFORMATION TECHNOLOGY,0,18,18
3425,"C.K. College of Engineering & Technology, JayaramNagar, Chellangkuppam, Cuddalore-607003.",ME,MECHANICAL ENGINEERING,49,50,1
3425,"C.K. College of Engineering & Technology, JayaramNagar, Chellangkuppam, Cuddalore-607003.",RM,ROBOTICS AND AUTOMATION,0,27,27
3454,"Sri Ramakrishna College of Engineering, Sri SaradhaNagar, NH - 45, Perambalur-621113.",AD,Artificial Intelligence and DataScience,35,36,1
3454,"Sri Ramakrishna College of Engineering, Sri SaradhaNagar, NH - 45, Perambalur-621113.",AG,AGRICULTURE ENGINEERING,35,35,0
3454,"Sri Ramakrishna College of Engineering, Sri SaradhaNagar, NH - 45, Perambalur-621113.",BM,BIO MEDICAL ENGINEERING,35,35,0
3454,"Sri Ramakrishna College of Engineering, Sri SaradhaNagar, NH - 45, Perambalur-621113.",CE,CIVIL  ENGINEERING,18,16,-2
3454,"Sri Ramakrishna College of Engineering, Sri SaradhaNagar, NH - 45, Perambalur-621113.",CS,COMPUTER SCIENCE ANDENGINEERING,53,54,1
3454,"Sri Ramakrishna College of Engineering, Sri SaradhaNagar, NH - 45, Perambalur-621113.",ME,MECHANICAL ENGINEERING,17,17,0
3454,"Sri Ramakrishna College of Engineering, Sri SaradhaNagar, NH - 45, Perambalur-621113.",SC,Computer Science andEngineering (Cyber Security),18,19,1
3456,"KSK College of Engineering and Technology,Thanjavur Main Road, Ammapet (Village),Dharasuram Post, Kumbakonam Taluk, ThanjavurDistrict-612702.",AD,Artificial Intelligence and DataScience,55,54,-1
3456,"KSK College of Engineering and Technology,Thanjavur Main Road, Ammapet (Village),Dharasuram Post, Kumbakonam Taluk, ThanjavurDistrict-612702.",AG,AGRICULTURE ENGINEERING,27,28,1
3456,"KSK College of Engineering and Technology,Thanjavur Main Road, Ammapet (Village),Dharasuram Post, Kumbakonam Taluk, ThanjavurDistrict-612702.",AM,COMPUTER SCIENCE ANDENGINEERING (AI ANDMACHINE LEARNING),27,28,1
3456,"KSK College of Engineering and Technology,Thanjavur Main Road, Ammapet (Village),Dharasuram Post, Kumbakonam Taluk, ThanjavurDistrict-612702.",BM,BIO MEDICAL ENGINEERING,54,53,-1
3456,"KSK College of Engineering and Technology,Thanjavur Main Road, Ammapet (Village),Dharasuram Post, Kumbakonam Taluk, ThanjavurDistrict-612702.",CS,COMPUTER SCIENCE ANDENGINEERING,51,51,0
3456,"KSK College of Engineering and Technology,Thanjavur Main Road, Ammapet (Village),Dharasuram Post, Kumbakonam Taluk, ThanjavurDistrict-612702.",EC,ELECTRONICS ANDCOMMUNICATIONENGINEERING,27,28,1
3456,"KSK College of Engineering and Technology,Thanjavur Main Road, Ammapet (Village),Dharasuram Post, Kumbakonam Taluk, ThanjavurDistrict-612702.",EE,ELECTRICAL AND ELECTRONICSENGINEERING,27,28,1
3456,"KSK College of Engineering and Technology,Thanjavur Main Road, Ammapet (Village),Dharasuram Post, Kumbakonam Taluk, ThanjavurDistrict-612702.",ME,MECHANICAL ENGINEERING,54,53,-1
3460,"Surya College of Engineering , Somu Nagar, Konalai,Tiruchirappalli-621132.",CE,CIVIL  ENGINEERING,55,55,0
3460,"Surya College of Engineering , Somu Nagar, Konalai,Tiruchirappalli-621132.",CS,COMPUTER SCIENCE ANDENGINEERING,54,49,-5
3460,"Surya College of Engineering , Somu Nagar, Konalai,Tiruchirappalli-621132.",EE,ELECTRICAL AND ELECTRONICSENGINEERING,54,49,-5
3460,"Surya College of Engineering , Somu Nagar, Konalai,Tiruchirappalli-621132.",ME,MECHANICAL ENGINEERING,54,49,-5
3461,"Arifa Institute of Technology, Esanoor, Keelaiyur Post,Tirukkuvalai Taluk, Nagapattinam District-611103.",AD,Artificial Intelligence and DataScience,54,54,0
3461,"Arifa Institute of Technology, Esanoor, Keelaiyur Post,Tirukkuvalai Taluk, Nagapattinam District-611103.",CS,COMPUTER SCIENCE ANDENGINEERING,53,54,1
3461,"Arifa Institute of Technology, Esanoor, Keelaiyur Post,Tirukkuvalai Taluk, Nagapattinam District-611103.",EC,ELECTRONICS ANDCOMMUNICATIONENGINEERING,27,28,1
3461,"Arifa Institute of Technology, Esanoor, Keelaiyur Post,Tirukkuvalai Taluk, Nagapattinam District-611103.",EE,ELECTRICAL AND ELECTRONICSENGINEERING,27,27,0
3461,"Arifa Institute of Technology, Esanoor, Keelaiyur Post,Tirukkuvalai Taluk, Nagapattinam District-611103.",IT,INFORMATION TECHNOLOGY,0,28,28
3461,"Arifa Institute of Technology, Esanoor, Keelaiyur Post,Tirukkuvalai Taluk, Nagapattinam District-611103.",ME,MECHANICAL ENGINEERING,55,27,-28
3461,"Arifa Institute of Technology, Esanoor, Keelaiyur Post,Tirukkuvalai Taluk, Nagapattinam District-611103.",SC,Computer Science andEngineering (Cyber Security),0,27,27
3462,Ariyalur Engineering College  NH-227  Trichy-Chithambaram NH  Karuppur-Senapathy Post  AriyalurDistrict 621707,CE,CIVIL  ENGINEERING,55,0,-55
3462,Ariyalur Engineering College  NH-227  Trichy-Chithambaram NH  Karuppur-Senapathy Post  AriyalurDistrict 621707,CS,COMPUTER SCIENCE ANDENGINEERING,54,0,-54
3462,Ariyalur Engineering College  NH-227  Trichy-Chithambaram NH  Karuppur-Senapathy Post  AriyalurDistrict 621707,EC,ELECTRONICS ANDCOMMUNICATIONENGINEERING,27,0,-27
3462,Ariyalur Engineering College  NH-227  Trichy-Chithambaram NH  Karuppur-Senapathy Post  AriyalurDistrict 621707,EE,ELECTRICAL ANDELECTRONICS ENGINEERING,54,0,-54
3462,Ariyalur Engineering College  NH-227  Trichy-Chithambaram NH  Karuppur-Senapathy Post  AriyalurDistrict 621707,ME,MECHANICAL ENGINEERING,54,0,-54
3464,Government College of Engineering  GandarvakottaiRoad  Sengipatti  Thanjavur District 613402,CE,CIVIL  ENGINEERING,55,54,-1
3464,Government College of Engineering  GandarvakottaiRoad  Sengipatti  Thanjavur District 613402,CS,COMPUTER SCIENCE ANDENGINEERING,50,55,5
3464,Government College of Engineering  GandarvakottaiRoad  Sengipatti  Thanjavur District 613402,EC,ELECTRONICS ANDCOMMUNICATIONENGINEERING,51,55,4
3464,Government College of Engineering  GandarvakottaiRoad  Sengipatti  Thanjavur District 613402,EE,ELECTRICAL AND ELECTRONICSENGINEERING,55,53,-2
3464,Government College of Engineering  GandarvakottaiRoad  Sengipatti  Thanjavur District 613402,ME,MECHANICAL ENGINEERING,55,55,0
3465,Government College of Engineering  SrirangamSethurappatti  Tiruchirappalli District 620012,CE,CIVIL  ENGINEERING,54,54,0
3465,Government College of Engineering  SrirangamSethurappatti  Tiruchirappalli District 620012,CS,COMPUTER SCIENCE ANDENGINEERING,54,54,0
3465,Government College of Engineering  SrirangamSethurappatti  Tiruchirappalli District 620012,EC,ELECTRONICS ANDCOMMUNICATIONENGINEERING,54,54,0
3465,Government College of Engineering  SrirangamSethurappatti  Tiruchirappalli District 620012,EE,ELECTRICAL AND ELECTRONICSENGINEERING,53,55,2
3465,Government College of Engineering  SrirangamSethurappatti  Tiruchirappalli District 620012,ME,MECHANICAL ENGINEERING,54,55,1
3466,"Nelliandavar Institute of Technology, NerunjikoraiVillage, Pudhupalayam, Ariyalur Taluk & District-621704.",AD,Artificial Intelligence and DataScience,54,55,1
3466,Nelliandavar Institute of Technology  NerunjikoraiVillage  Pudhupalayam  Ariyalur Taluk  Ariyalur District621704,CE,CIVIL  ENGINEERING,15,0,-15
3466,"Nelliandavar Institute of Technology, NerunjikoraiVillage, Pudhupalayam, Ariyalur Taluk & District-621704.",CS,COMPUTER SCIENCE ANDENGINEERING,55,55,0
3466,"Nelliandavar Institute of Technology, NerunjikoraiVillage, Pudhupalayam, Ariyalur Taluk & District-621704.",EC,ELECTRONICS ANDCOMMUNICATIONENGINEERING,55,54,-1
3466,"Nelliandavar Institute of Technology, NerunjikoraiVillage, Pudhupalayam, Ariyalur Taluk & District-621704.",EE,ELECTRICAL AND ELECTRONICSENGINEERING,55,54,-1
3466,"Nelliandavar Institute of Technology, NerunjikoraiVillage, Pudhupalayam, Ariyalur Taluk & District-621704.",ME,MECHANICAL ENGINEERING,55,54,-1
3701,"K Ramakrishnan College of Technology(Autonomous), Kariyamanickam Road,Mannachanallur Taluk, Tiruchirappalli-621112.",AD,Artificial Intelligence and DataScience,74,70,-4
3701,"K Ramakrishnan College of Technology(Autonomous), Kariyamanickam Road,Mannachanallur Taluk, Tiruchirappalli-621112.",AM,COMPUTER SCIENCE ANDENGINEERING (AI ANDMACHINE LEARNING),40,36,-4
3701,"K Ramakrishnan College of Technology(Autonomous), Kariyamanickam Road,Mannachanallur Taluk, Tiruchirappalli-621112.",CE,CIVIL  ENGINEERING,35,36,1
3701,"K Ramakrishnan College of Technology(Autonomous), Kariyamanickam Road,Mannachanallur Taluk, Tiruchirappalli-621112.",CS,COMPUTER SCIENCE ANDENGINEERING,104,105,1
3701,"K Ramakrishnan College of Technology(Autonomous), Kariyamanickam Road,Mannachanallur Taluk, Tiruchirappalli-621112.",EC,ELECTRONICS ANDCOMMUNICATIONENGINEERING,71,70,-1
3701,"K Ramakrishnan College of Technology(Autonomous), Kariyamanickam Road,Mannachanallur Taluk, Tiruchirappalli-621112.",EE,ELECTRICAL AND ELECTRONICSENGINEERING,35,36,1
3701,"K Ramakrishnan College of Technology(Autonomous), Kariyamanickam Road,Mannachanallur Taluk, Tiruchirappalli-621112.",IT,INFORMATION TECHNOLOGY,39,36,-3
3701,"K Ramakrishnan College of Technology(Autonomous), Kariyamanickam Road,Mannachanallur Taluk, Tiruchirappalli-621112.",ME,MECHANICAL ENGINEERING,35,36,1
3760,"Sir Issac Newton College of Engineering andTechnology, Andhanapeetai Post, Pappakoil,Nagapattinam-611102.",AD,Artificial Intelligence and DataScience,43,50,7
3760,"Sir Issac Newton College of Engineering andTechnology, Andhanapeetai Post, Pappakoil,Nagapattinam-611102.",AG,AGRICULTURE ENGINEERING,43,45,2
3760,"Sir Issac Newton College of Engineering andTechnology, Andhanapeetai Post, Pappakoil,Nagapattinam-611102.",CS,COMPUTER SCIENCE ANDENGINEERING,44,50,6
3760,"Sir Issac Newton College of Engineering andTechnology, Andhanapeetai Post, Pappakoil,Nagapattinam-611102.",EC,ELECTRONICS ANDCOMMUNICATIONENGINEERING,45,50,5
3760,"Sir Issac Newton College of Engineering andTechnology, Andhanapeetai Post, Pappakoil,Nagapattinam-611102.",IT,INFORMATION TECHNOLOGY,45,50,5
3760,"Sir Issac Newton College of Engineering andTechnology, Andhanapeetai Post, Pappakoil,Nagapattinam-611102.",ME,MECHANICAL ENGINEERING,45,45,0
3766,"Star Lion College of Engineering and Technology,Main Road, Manankorai, Thanjavur-614206.",AD,Artificial Intelligence and DataScience,17,21,4
3766,"Star Lion College of Engineering and Technology,Main Road, Manankorai, Thanjavur-614206.",AM,COMPUTER SCIENCE ANDENGINEERING (AI ANDMACHINE LEARNING),18,27,9
3766,"Star Lion College of Engineering and Technology,Main Road, Manankorai, Thanjavur-614206.",CE,CIVIL  ENGINEERING,27,27,0
3766,"Star Lion College of Engineering and Technology,Main Road, Manankorai, Thanjavur-614206.",CS,COMPUTER SCIENCE ANDENGINEERING,35,45,10
3766,"Star Lion College of Engineering and Technology,Main Road, Manankorai, Thanjavur-614206.",EC,ELECTRONICS ANDCOMMUNICATIONENGINEERING,28,27,-1
3766,"Star Lion College of Engineering and Technology,Main Road, Manankorai, Thanjavur-614206.",EE,ELECTRICAL AND ELECTRONICSENGINEERING,27,28,1
3766,"Star Lion College of Engineering and Technology,Main Road, Manankorai, Thanjavur-614206.",ME,MECHANICAL ENGINEERING,54,45,-9
3782,"OASYS Institute of Technology, Tiruchirappalli-Thuraiyur Mani Road, Pulivalam P.O Musiri Taluk,Tiruchirappalli-621006.",AD,Artificial Intelligence and DataScience,23,49,26
3782,"OASYS Institute of Technology, Tiruchirappalli-Thuraiyur Mani Road, Pulivalam P.O Musiri Taluk,Tiruchirappalli-621006.",AM,COMPUTER SCIENCE ANDENGINEERING (AI ANDMACHINE LEARNING),0,49,49
3782,"OASYS Institute of Technology, Tiruchirappalli-Thuraiyur Mani Road, Pulivalam P.O Musiri Taluk,Tiruchirappalli-621006.",CB,COMPUTER SCIENCE ANDBUSSINESS SYSTEM,22,49,27
3782,"OASYS Institute of Technology, Tiruchirappalli-Thuraiyur Mani Road, Pulivalam P.O Musiri Taluk,Tiruchirappalli-621006.",CS,COMPUTER SCIENCE ANDENGINEERING,100,98,-2
3782,"OASYS Institute of Technology, Tiruchirappalli-Thuraiyur Mani Road, Pulivalam P.O Musiri Taluk,Tiruchirappalli-621006.",EC,ELECTRONICS ANDCOMMUNICATIONENGINEERING,52,49,-3
3782,"OASYS Institute of Technology, Tiruchirappalli-Thuraiyur Mani Road, Pulivalam P.O Musiri Taluk,Tiruchirappalli-621006.",EE,ELECTRICAL AND ELECTRONICSENGINEERING,26,21,-5
3782,"OASYS Institute of Technology, Tiruchirappalli-Thuraiyur Mani Road, Pulivalam P.O Musiri Taluk,Tiruchirappalli-621006.",IT,INFORMATION TECHNOLOGY,52,49,-3
3782,OASYS Institute of Technology   Pulivalam Village  MusiriTaluk  Tiruchirappalli District 621006,ME,MECHANICAL ENGINEERING,25,0,-25
3786,"M.A.M. School of Engineering (Autonomous), Trichy-Chennai Trunk Road, Siruganur, Tiruchirappalli-621105.",AD,Artificial Intelligence and DataScience,14,34,20
3786,"M.A.M. School of Engineering (Autonomous), Trichy-Chennai Trunk Road, Siruganur, Tiruchirappalli-621105.",AE,AERONAUTICAL ENGINEERING,45,47,2
3786,"M.A.M. School of Engineering (Autonomous), Trichy-Chennai Trunk Road, Siruganur, Tiruchirappalli-621105.",BM,BIO MEDICAL ENGINEERING,31,31,0
3786,"M.A.M. School of Engineering (Autonomous), Trichy-Chennai Trunk Road, Siruganur, Tiruchirappalli-621105.",CS,COMPUTER SCIENCE ANDENGINEERING,35,32,-3
3786,"M.A.M. School of Engineering (Autonomous), Trichy-Chennai Trunk Road, Siruganur, Tiruchirappalli-621105.",EC,ELECTRONICS ANDCOMMUNICATIONENGINEERING,44,41,-3
3786,"M.A.M. School of Engineering (Autonomous), Trichy-Chennai Trunk Road, Siruganur, Tiruchirappalli-621105.",EE,ELECTRICAL AND ELECTRONICSENGINEERING,55,22,-33
3786,"M.A.M. School of Engineering (Autonomous), Trichy-Chennai Trunk Road, Siruganur, Tiruchirappalli-621105.",IT,INFORMATION TECHNOLOGY,0,18,18
3786,"M.A.M. School of Engineering (Autonomous), Trichy-Chennai Trunk Road, Siruganur, Tiruchirappalli-621105.",ME,MECHANICAL ENGINEERING,55,22,-33
3786,"M.A.M. School of Engineering (Autonomous), Trichy-Chennai Trunk Road, Siruganur, Tiruchirappalli-621105.",MZ,Mechatronics Engineering,27,22,-5
3795,SRM TRP Engineering College  IrungalurManachanallur Taluk  Tiruchirappalli District 621105,AD,Artificial Intelligence and DataScience,35,106,71
3795,SRM TRP Engineering College  IrungalurManachanallur Taluk  Tiruchirappalli District 621105,CE,CIVIL  ENGINEERING,35,36,1
3795,SRM TRP Engineering College  IrungalurManachanallur Taluk  Tiruchirappalli District 621105,CS,COMPUTER SCIENCE ANDENGINEERING,106,105,-1
3795,SRM TRP Engineering College  IrungalurManachanallur Taluk  Tiruchirappalli District 621105,EC,ELECTRONICS ANDCOMMUNICATIONENGINEERING,68,72,4
3795,SRM TRP Engineering College  IrungalurManachanallur Taluk  Tiruchirappalli District 621105,EE,ELECTRICAL AND ELECTRONICSENGINEERING,35,36,1
3795,SRM TRP Engineering College  IrungalurManachanallur Taluk  Tiruchirappalli District 621105,ME,MECHANICAL ENGINEERING,71,70,-1
3801,"A.V.C. College of Engineering, Mannampandal,Mayiladuthurai, Nagapattinam-609305.",AD,Artificial Intelligence and DataScience,0,35,35
3801,"A.V.C. College of Engineering, Mannampandal,Mayiladuthurai, Nagapattinam-609305.",CE,CIVIL  ENGINEERING,35,18,-17
3801,"A.V.C. College of Engineering, Mannampandal,Mayiladuthurai, Nagapattinam-609305.",CS,COMPUTER SCIENCE ANDENGINEERING,70,72,2
3801,"A.V.C. College of Engineering, Mannampandal,Mayiladuthurai, Nagapattinam-609305.",EC,ELECTRONICS ANDCOMMUNICATIONENGINEERING,35,35,0
3801,"A.V.C. College of Engineering, Mannampandal,Mayiladuthurai, Nagapattinam-609305.",EE,ELECTRICAL AND ELECTRONICSENGINEERING,35,35,0
3801,"A.V.C. College of Engineering, Mannampandal,Mayiladuthurai, Nagapattinam-609305.",IC,INSTRUMENTATION ANDCONTROL ENGINEERING,18,18,0
3801,"A.V.C. College of Engineering, Mannampandal,Mayiladuthurai, Nagapattinam-609305.",IT,INFORMATION TECHNOLOGY,72,70,-2
3801,"A.V.C. College of Engineering, Mannampandal,Mayiladuthurai, Nagapattinam-609305.",ME,MECHANICAL ENGINEERING,35,17,-18
3802,Shri Angalamman College of Engineering andTechnology Siruganoor Tiruchirapalli-621 105,CE,CIVIL  ENGINEERING,18,0,-18
3802,Shri Angalamman College of Engineering andTechnology Siruganoor Tiruchirapalli-621 105,CS,COMPUTER SCIENCE ANDENGINEERING,35,0,-35
3802,Shri Angalamman College of Engineering andTechnology Siruganoor Tiruchirapalli-621 105,EE,ELECTRICAL ANDELECTRONICS ENGINEERING,18,0,-18
3802,Shri Angalamman College of Engineering andTechnology Siruganoor Tiruchirapalli-621 105,ME,MECHANICAL ENGINEERING,35,0,-35
3803,"Anjalai Ammal Mahalingam Engineering College,Kovilvenni, Thiruvarur-614403.",CE,CIVIL  ENGINEERING,17,17,0
3803,"Anjalai Ammal Mahalingam Engineering College,Kovilvenni, Thiruvarur-614403.",CH,CHEMICAL  ENGINEERING,18,19,1
3803,"Anjalai Ammal Mahalingam Engineering College,Kovilvenni, Thiruvarur-614403.",CS,COMPUTER SCIENCE ANDENGINEERING,52,53,1
3803,"Anjalai Ammal Mahalingam Engineering College,Kovilvenni, Thiruvarur-614403.",EC,ELECTRONICS ANDCOMMUNICATIONENGINEERING,54,53,-1
3803,"Anjalai Ammal Mahalingam Engineering College,Kovilvenni, Thiruvarur-614403.",EE,ELECTRICAL AND ELECTRONICSENGINEERING,35,35,0
3803,"Anjalai Ammal Mahalingam Engineering College,Kovilvenni, Thiruvarur-614403.",IT,INFORMATION TECHNOLOGY,54,53,-1
3803,"Anjalai Ammal Mahalingam Engineering College,Kovilvenni, Thiruvarur-614403.",ME,MECHANICAL ENGINEERING,35,35,0
3804,"Arasu Engineering College, Chennai Main Road,Thiruvisanallur - Village, Thiruvidaimaruthur - Taluk,Kumbakonam,Thanjavur-612501.",AD,Artificial Intelligence and DataScience,41,36,-5
3804,Arasu Engineering  College  Chennai Main RoadKumbakonam  Thanjavur District 612501,AG,AGRICULTURAL ENGINEERING,50,0,-50
3804,"Arasu Engineering College, Chennai Main Road,Thiruvisanallur - Village, Thiruvidaimaruthur - Taluk,Kumbakonam,Thanjavur-612501.",BM,BIO MEDICAL ENGINEERING,50,50,0
3804,Arasu Engineering  College  Chennai Main RoadKumbakonam  Thanjavur District 612501,CE,CIVIL  ENGINEERING,23,0,-23
3804,"Arasu Engineering College, Chennai Main Road,Thiruvisanallur - Village, Thiruvidaimaruthur - Taluk,Kumbakonam,Thanjavur-612501.",CS,COMPUTER SCIENCE ANDENGINEERING,64,87,23
3804,"Arasu Engineering College, Chennai Main Road,Thiruvisanallur - Village, Thiruvidaimaruthur - Taluk,Kumbakonam,Thanjavur-612501.",EC,ELECTRONICS ANDCOMMUNICATIONENGINEERING,50,50,0
3804,"Arasu Engineering College, Chennai Main Road,Thiruvisanallur - Village, Thiruvidaimaruthur - Taluk,Kumbakonam,Thanjavur-612501.",EE,ELECTRICAL AND ELECTRONICSENGINEERING,39,38,-1
3804,"Arasu Engineering College, Chennai Main Road,Thiruvisanallur - Village, Thiruvidaimaruthur - Taluk,Kumbakonam,Thanjavur-612501.",IT,INFORMATION TECHNOLOGY,0,41,41
3804,"Arasu Engineering College, Chennai Main Road,Thiruvisanallur - Village, Thiruvidaimaruthur - Taluk,Kumbakonam,Thanjavur-612501.",ME,MECHANICAL ENGINEERING,50,49,-1
3805,"Dhanalakshmi Srinivasan Engineering College(Autonomous), Thuraiyur Road, Perambalur-621212.",AD,Artificial Intelligence and DataScience,81,162,81
3805,"Dhanalakshmi Srinivasan Engineering College(Autonomous), Thuraiyur Road, Perambalur-621212.",AE,AERONAUTICAL ENGINEERING,55,55,0
3805,"Dhanalakshmi Srinivasan Engineering College(Autonomous), Thuraiyur Road, Perambalur-621212.",AG,AGRICULTURE ENGINEERING,55,55,0
3805,"Dhanalakshmi Srinivasan Engineering College(Autonomous), Thuraiyur Road, Perambalur-621212.",BM,BIO MEDICAL ENGINEERING,98,109,11
3805,"Dhanalakshmi Srinivasan Engineering College(Autonomous), Thuraiyur Road, Perambalur-621212.",BT,BIO TECHNOLOGY,54,55,1
3805,"Dhanalakshmi Srinivasan Engineering College(Autonomous), Thuraiyur Road, Perambalur-621212.",CE,CIVIL  ENGINEERING,55,54,-1
3805,"Dhanalakshmi Srinivasan Engineering College(Autonomous), Thuraiyur Road, Perambalur-621212.",CH,CHEMICAL  ENGINEERING,27,27,0
3805,"Dhanalakshmi Srinivasan Engineering College(Autonomous), Thuraiyur Road, Perambalur-621212.",CS,COMPUTER SCIENCE ANDENGINEERING,80,162,82
3805,"Dhanalakshmi Srinivasan Engineering College(Autonomous), Thuraiyur Road, Perambalur-621212.",EC,ELECTRONICS ANDCOMMUNICATIONENGINEERING,130,163,33
3805,"Dhanalakshmi Srinivasan Engineering College(Autonomous), Thuraiyur Road, Perambalur-621212.",EE,ELECTRICAL AND ELECTRONICSENGINEERING,55,54,-1
3805,"Dhanalakshmi Srinivasan Engineering College(Autonomous), Thuraiyur Road, Perambalur-621212.",FD,FOOD TECHNOLOGY,54,55,1
3805,"Dhanalakshmi Srinivasan Engineering College(Autonomous), Thuraiyur Road, Perambalur-621212.",IT,INFORMATION TECHNOLOGY,81,162,81
3805,"Dhanalakshmi Srinivasan Engineering College(Autonomous), Thuraiyur Road, Perambalur-621212.",ME,MECHANICAL ENGINEERING,55,55,0
3805,"Dhanalakshmi Srinivasan Engineering College(Autonomous), Thuraiyur Road, Perambalur-621212.",PH,PHARMACEUTICALTECHNOLOGY,55,55,0
3805,"Dhanalakshmi Srinivasan Engineering College(Autonomous), Thuraiyur Road, Perambalur-621212.",RM,ROBOTICS AND AUTOMATION,27,27,0
3805,"Dhanalakshmi Srinivasan Engineering College(Autonomous), Thuraiyur Road, Perambalur-621212.",SC,Computer Science andEngineering (Cyber Security),27,55,28
3806,"E.G.S. Pillay Engineering College (Autonomous), OldNagore Road, Nagore Post, Nagapattinam District-611002.",AD,Artificial Intelligence and DataScience,34,70,36
3806,"E.G.S. Pillay Engineering College (Autonomous), OldNagore Road, Nagore Post, Nagapattinam District-611002.",BM,BIO MEDICAL ENGINEERING,49,49,0
3806,"E.G.S. Pillay Engineering College (Autonomous), OldNagore Road, Nagore Post, Nagapattinam District-611002.",CB,COMPUTER SCIENCE ANDBUSSINESS SYSTEM,49,46,-3
3806,"E.G.S. Pillay Engineering College (Autonomous), OldNagore Road, Nagore Post, Nagapattinam District-611002.",CE,CIVIL  ENGINEERING,52,55,3
3806,"E.G.S. Pillay Engineering College (Autonomous), OldNagore Road, Nagore Post, Nagapattinam District-611002.",CS,COMPUTER SCIENCE ANDENGINEERING,105,111,6
3806,"E.G.S. Pillay Engineering College (Autonomous), OldNagore Road, Nagore Post, Nagapattinam District-611002.",EC,ELECTRONICS ANDCOMMUNICATIONENGINEERING,104,92,-12
3806,"E.G.S. Pillay Engineering College (Autonomous), OldNagore Road, Nagore Post, Nagapattinam District-611002.",EE,ELECTRICAL AND ELECTRONICSENGINEERING,52,46,-6
3806,"E.G.S. Pillay Engineering College (Autonomous), OldNagore Road, Nagore Post, Nagapattinam District-611002.",IT,INFORMATION TECHNOLOGY,70,71,1
3806,"E.G.S. Pillay Engineering College (Autonomous), OldNagore Road, Nagore Post, Nagapattinam District-611002.",ME,MECHANICAL ENGINEERING,104,99,-5
3807,"J.J. College of Engineering and Technology,Ammapettai, Poolankulathupatti Post, Tiruchirappalli-620009.",AD,Artificial Intelligence and DataScience,34,105,71
3807,"J.J. College of Engineering and Technology,Ammapettai, Poolankulathupatti Post, Tiruchirappalli-620009.",AE,AERONAUTICAL ENGINEERING,18,19,1
3807,"J.J. College of Engineering and Technology,Ammapettai, Poolankulathupatti Post, Tiruchirappalli-620009.",CE,CIVIL  ENGINEERING,18,18,0
3807,"J.J. College of Engineering and Technology,Ammapettai, Poolankulathupatti Post, Tiruchirappalli-620009.",CS,COMPUTER SCIENCE ANDENGINEERING,106,105,-1
3807,"J.J. College of Engineering and Technology,Ammapettai, Poolankulathupatti Post, Tiruchirappalli-620009.",EC,ELECTRONICS ANDCOMMUNICATIONENGINEERING,35,36,1
3807,"J.J. College of Engineering and Technology,Ammapettai, Poolankulathupatti Post, Tiruchirappalli-620009.",EE,ELECTRICAL AND ELECTRONICSENGINEERING,35,35,0
3807,"J.J. College of Engineering and Technology,Ammapettai, Poolankulathupatti Post, Tiruchirappalli-620009.",IT,INFORMATION TECHNOLOGY,35,70,35
3807,"J.J. College of Engineering and Technology,Ammapettai, Poolankulathupatti Post, Tiruchirappalli-620009.",ME,MECHANICAL ENGINEERING,35,36,1
3807,"J.J. College of Engineering and Technology,Ammapettai, Poolankulathupatti Post, Tiruchirappalli-620009.",SC,Computer Science andEngineering (Cyber Security),35,36,1
3808,"Jayaram College of Engineering and Technology,Karattampatty, Pagalavadi, Thuraiyur Taluk,Tiruchirappalli-621014.",CE,CIVIL  ENGINEERING,49,49,0
3808,"Jayaram College of Engineering and Technology,Karattampatty, Pagalavadi, Thuraiyur Taluk,Tiruchirappalli-621014.",CS,COMPUTER SCIENCE ANDENGINEERING,45,49,4
3808,"Jayaram College of Engineering and Technology,Karattampatty, Pagalavadi, Thuraiyur Taluk,Tiruchirappalli-621014.",EC,ELECTRONICS ANDCOMMUNICATIONENGINEERING,49,49,0
3808,"Jayaram College of Engineering and Technology,Karattampatty, Pagalavadi, Thuraiyur Taluk,Tiruchirappalli-621014.",EE,ELECTRICAL AND ELECTRONICSENGINEERING,49,49,0
3808,"Jayaram College of Engineering and Technology,Karattampatty, Pagalavadi, Thuraiyur Taluk,Tiruchirappalli-621014.",IT,INFORMATION TECHNOLOGY,21,22,1
3808,"Jayaram College of Engineering and Technology,Karattampatty, Pagalavadi, Thuraiyur Taluk,Tiruchirappalli-621014.",ME,MECHANICAL ENGINEERING,49,49,0
3809,Kurinji College of Engineering and TechnologyManapparai  Tiruchirappalli District 621307,CS,COMPUTER SCIENCE ANDENGINEERING,31,0,-31
3809,Kurinji College of Engineering and TechnologyManapparai  Tiruchirappalli District 621307,EC,ELECTRONICS ANDCOMMUNICATIONENGINEERING,45,0,-45
3809,Kurinji College of Engineering and TechnologyManapparai  Tiruchirappalli District 621307,EE,ELECTRICAL ANDELECTRONICS ENGINEERING,46,0,-46
3809,Kurinji College of Engineering and TechnologyManapparai  Tiruchirappalli District 621307,ME,MECHANICAL ENGINEERING,45,0,-45
3810,"M A M College of Engineering, Trichy-Chennai TrunkRoad, Siruganur, Tiruchirappalli-621105.",AD,Artificial Intelligence and DataScience,36,27,-9
3810,"M A M College of Engineering, Trichy-Chennai TrunkRoad, Siruganur, Tiruchirappalli-621105.",AG,AGRICULTURE ENGINEERING,41,45,4
3810,"M A M College of Engineering, Trichy-Chennai TrunkRoad, Siruganur, Tiruchirappalli-621105.",AM,COMPUTER SCIENCE ANDENGINEERING (AI ANDMACHINE LEARNING),0,41,41
3810,"M A M College of Engineering, Trichy-Chennai TrunkRoad, Siruganur, Tiruchirappalli-621105.",BM,BIO MEDICAL ENGINEERING,45,64,19
3810,"M A M College of Engineering, Trichy-Chennai TrunkRoad, Siruganur, Tiruchirappalli-621105.",BT,BIO TECHNOLOGY,0,41,41
3810,"M A M College of Engineering, Trichy-Chennai TrunkRoad, Siruganur, Tiruchirappalli-621105.",CE,CIVIL  ENGINEERING,23,18,-5
3810,"M A M College of Engineering, Trichy-Chennai TrunkRoad, Siruganur, Tiruchirappalli-621105.",CS,COMPUTER SCIENCE ANDENGINEERING,112,113,1
3810,"M A M College of Engineering, Trichy-Chennai TrunkRoad, Siruganur, Tiruchirappalli-621105.",EC,ELECTRONICS ANDCOMMUNICATIONENGINEERING,45,45,0
3810,"M A M College of Engineering, Trichy-Chennai TrunkRoad, Siruganur, Tiruchirappalli-621105.",EE,ELECTRICAL AND ELECTRONICSENGINEERING,36,45,9
3810,"M A M College of Engineering, Trichy-Chennai TrunkRoad, Siruganur, Tiruchirappalli-621105.",EI,ELECTRONICS ANDINSTRUMENTATIONENGINEERING,19,18,-1
3810,"M A M College of Engineering, Trichy-Chennai TrunkRoad, Siruganur, Tiruchirappalli-621105.",FD,FOOD TECHNOLOGY,37,36,-1
3810,"M A M College of Engineering, Trichy-Chennai TrunkRoad, Siruganur, Tiruchirappalli-621105.",IT,INFORMATION TECHNOLOGY,36,55,19
3810,"M A M College of Engineering, Trichy-Chennai TrunkRoad, Siruganur, Tiruchirappalli-621105.",ME,MECHANICAL ENGINEERING,36,41,5
3810,"M A M College of Engineering, Trichy-Chennai TrunkRoad, Siruganur, Tiruchirappalli-621105.",SC,Computer Science andEngineering (Cyber Security),0,41,41
3811,"M.I.E.T. Engineering College (Autonomous), Trichy -Pudukkottai Road, Gundur, Tiruchirappalli-620007.",AD,Artificial Intelligence and DataScience,28,36,8
3811,"M.I.E.T. Engineering College (Autonomous), Trichy -Pudukkottai Road, Gundur, Tiruchirappalli-620007.",BM,BIO MEDICAL ENGINEERING,14,22,8
3811,"M.I.E.T. Engineering College (Autonomous), Trichy -Pudukkottai Road, Gundur, Tiruchirappalli-620007.",CE,CIVIL  ENGINEERING,14,22,8
3811,"M.I.E.T. Engineering College (Autonomous), Trichy -Pudukkottai Road, Gundur, Tiruchirappalli-620007.",CS,COMPUTER SCIENCE ANDENGINEERING,108,136,28
3811,"M.I.E.T. Engineering College (Autonomous), Trichy -Pudukkottai Road, Gundur, Tiruchirappalli-620007.",EC,ELECTRONICS ANDCOMMUNICATIONENGINEERING,27,45,18
3811,"M.I.E.T. Engineering College (Autonomous), Trichy -Pudukkottai Road, Gundur, Tiruchirappalli-620007.",EE,ELECTRICAL AND ELECTRONICSENGINEERING,26,45,19
3811,"M.I.E.T. Engineering College (Autonomous), Trichy -Pudukkottai Road, Gundur, Tiruchirappalli-620007.",IT,INFORMATION TECHNOLOGY,72,91,19
3811,"M.I.E.T. Engineering College (Autonomous), Trichy -Pudukkottai Road, Gundur, Tiruchirappalli-620007.",ME,MECHANICAL ENGINEERING,27,46,19
3812,"Mookambigai College of Engineering, Srinivasa Nagar,Kalamavur (PO), Keeranur, Pudukkottai-622502.",AD,Artificial Intelligence and DataScience,46,50,4
3812,"Mookambigai College of Engineering, Srinivasa Nagar,Kalamavur (PO), Keeranur, Pudukkottai-622502.",AM,COMPUTER SCIENCE ANDENGINEERING (AI ANDMACHINE LEARNING),0,25,25
3812,"Mookambigai College of Engineering, Srinivasa Nagar,Kalamavur (PO), Keeranur, Pudukkottai-622502.",CE,CIVIL  ENGINEERING,22,22,0
3812,"Mookambigai College of Engineering, Srinivasa Nagar,Kalamavur (PO), Keeranur, Pudukkottai-622502.",CS,COMPUTER SCIENCE ANDENGINEERING,91,100,9
3812,"Mookambigai College of Engineering, Srinivasa Nagar,Kalamavur (PO), Keeranur, Pudukkottai-622502.",EC,ELECTRONICS ANDCOMMUNICATIONENGINEERING,23,25,2
3812,"Mookambigai College of Engineering, Srinivasa Nagar,Kalamavur (PO), Keeranur, Pudukkottai-622502.",EE,ELECTRICAL AND ELECTRONICSENGINEERING,44,24,-20
3812,"Mookambigai College of Engineering, Srinivasa Nagar,Kalamavur (PO), Keeranur, Pudukkottai-622502.",EI,ELECTRONICS ANDINSTRUMENTATIONENGINEERING,22,25,3
3812,"Mookambigai College of Engineering, Srinivasa Nagar,Kalamavur (PO), Keeranur, Pudukkottai-622502.",IT,INFORMATION TECHNOLOGY,64,77,13
3812,"Mookambigai College of Engineering, Srinivasa Nagar,Kalamavur (PO), Keeranur, Pudukkottai-622502.",ME,MECHANICAL ENGINEERING,45,52,7
3813,"Oxford Engineering College, Pirattiyur, Tiruchirappalli-620009.",CE,CIVIL  ENGINEERING,41,40,-1
3813,"Oxford Engineering College, Pirattiyur, Tiruchirappalli-620009.",CS,COMPUTER SCIENCE ANDENGINEERING,35,54,19
3813,"Oxford Engineering College, Pirattiyur, Tiruchirappalli-620009.",EC,ELECTRONICS ANDCOMMUNICATIONENGINEERING,41,41,0
3813,"Oxford Engineering College, Pirattiyur, Tiruchirappalli-620009.",EE,ELECTRICAL AND ELECTRONICSENGINEERING,41,41,0
3813,"Oxford Engineering College, Pirattiyur, Tiruchirappalli-620009.",IT,INFORMATION TECHNOLOGY,36,53,17
3813,"Oxford Engineering College, Pirattiyur, Tiruchirappalli-620009.",ME,MECHANICAL ENGINEERING,41,41,0
3814,"P.R. Engineering College, Thanjavur-Trichy High ways,Vallam, Thanjavur-613403.",AD,Artificial Intelligence and DataScience,19,23,4
3814,"P.R. Engineering College, Thanjavur-Trichy High ways,Vallam, Thanjavur-613403.",CE,CIVIL  ENGINEERING,35,35,0
3814,"P.R. Engineering College, Thanjavur-Trichy High ways,Vallam, Thanjavur-613403.",CS,COMPUTER SCIENCE ANDENGINEERING,35,46,11
3814,"P.R. Engineering College, Thanjavur-Trichy High ways,Vallam, Thanjavur-613403.",EC,ELECTRONICS ANDCOMMUNICATIONENGINEERING,35,35,0
3814,"P.R. Engineering College, Thanjavur-Trichy High ways,Vallam, Thanjavur-613403.",EE,ELECTRICAL AND ELECTRONICSENGINEERING,18,18,0
3814,"P.R. Engineering College, Thanjavur-Trichy High ways,Vallam, Thanjavur-613403.",ME,MECHANICAL ENGINEERING,35,35,0
3815,"Pavendar Bharathidasan College of Engineering andTechnology, Thanjai Natarajan Nagar, Opp. toBharathidasan University, Pudukkottai Main Raod,Mathur, Kulathur, Pudukkottai-622515.",AD,Artificial Intelligence and DataScience,18,18,0
3815,"Pavendar Bharathidasan College of Engineering andTechnology, Thanjai Natarajan Nagar, Opp. toBharathidasan University, Pudukkottai Main Raod,Mathur, Kulathur, Pudukkottai-622515.",BM,BIO MEDICAL ENGINEERING,18,18,0
3815,"Pavendar Bharathidasan College of Engineering andTechnology, Thanjai Natarajan Nagar, Opp. toBharathidasan University, Pudukkottai Main Raod,Mathur, Kulathur, Pudukkottai-622515.",BT,BIO TECHNOLOGY,18,18,0
3815,"Pavendar Bharathidasan College of Engineering andTechnology, Thanjai Natarajan Nagar, Opp. toBharathidasan University, Pudukkottai Main Raod,Mathur, Kulathur, Pudukkottai-622515.",CS,COMPUTER SCIENCE ANDENGINEERING,34,36,2
3815,"Pavendar Bharathidasan College of Engineering andTechnology, Thanjai Natarajan Nagar, Opp. toBharathidasan University, Pudukkottai Main Raod,Mathur, Kulathur, Pudukkottai-622515.",EC,ELECTRONICS ANDCOMMUNICATIONENGINEERING,35,35,0
3815,"Pavendar Bharathidasan College of Engineering andTechnology, Thanjai Natarajan Nagar, Opp. toBharathidasan University, Pudukkottai Main Raod,Mathur, Kulathur, Pudukkottai-622515.",EE,ELECTRICAL AND ELECTRONICSENGINEERING,18,18,0
3815,"Pavendar Bharathidasan College of Engineering andTechnology, Thanjai Natarajan Nagar, Opp. toBharathidasan University, Pudukkottai Main Raod,Mathur, Kulathur, Pudukkottai-622515.",IT,INFORMATION TECHNOLOGY,35,35,0
3815,"Pavendar Bharathidasan College of Engineering andTechnology, Thanjai Natarajan Nagar, Opp. toBharathidasan University, Pudukkottai Main Raod,Mathur, Kulathur, Pudukkottai-622515.",ME,MECHANICAL ENGINEERING,17,17,0
3815,"Pavendar Bharathidasan College of Engineering andTechnology, Thanjai Natarajan Nagar, Opp. toBharathidasan University, Pudukkottai Main Raod,Mathur, Kulathur, Pudukkottai-622515.",TX,TEXTILE TECHNOLOGY,18,17,-1
3817,"Roever Engineering College, Elambalur (Post),Perambalur-621212.",BT,BIO TECHNOLOGY,36,45,9
3817,"Roever Engineering College, Elambalur (Post),Perambalur-621212.",CE,CIVIL  ENGINEERING,35,45,10
3817,"Roever Engineering College, Elambalur (Post),Perambalur-621212.",CS,COMPUTER SCIENCE ANDENGINEERING,46,64,18
3817,"Roever Engineering College, Elambalur (Post),Perambalur-621212.",EC,ELECTRONICS ANDCOMMUNICATIONENGINEERING,36,46,10
3817,"Roever Engineering College, Elambalur (Post),Perambalur-621212.",EE,ELECTRICAL AND ELECTRONICSENGINEERING,36,45,9
3817,"Roever Engineering College, Elambalur (Post),Perambalur-621212.",ME,MECHANICAL ENGINEERING,37,45,8
3819,"Saranathan College of Engineering (Autonomous),Venkateswara Nagar, Edamalaipattipudur Post,Panjappur Village, Srirangam Taluk, Tiruchirappalli-620012.",AD,Artificial Intelligence and DataScience,69,70,1
3819,"Saranathan College of Engineering (Autonomous),Venkateswara Nagar, Edamalaipattipudur Post,Panjappur Village, Srirangam Taluk, Tiruchirappalli-620012.",AM,COMPUTER SCIENCE ANDENGINEERING (AI ANDMACHINE LEARNING),34,36,2
3819,"Saranathan College of Engineering (Autonomous),Venkateswara Nagar, Edamalaipattipudur Post,Panjappur Village, Srirangam Taluk, Tiruchirappalli-620012.",CB,COMPUTER SCIENCE ANDBUSSINESS SYSTEM,35,35,0
3819,"Saranathan College of Engineering (Autonomous),Venkateswara Nagar, Edamalaipattipudur Post,Panjappur Village, Srirangam Taluk, Tiruchirappalli-620012.",CE,CIVIL  ENGINEERING,19,16,-3
3819,"Saranathan College of Engineering (Autonomous),Venkateswara Nagar, Edamalaipattipudur Post,Panjappur Village, Srirangam Taluk, Tiruchirappalli-620012.",CS,COMPUTER SCIENCE ANDENGINEERING,70,71,1
3819,"Saranathan College of Engineering (Autonomous),Venkateswara Nagar, Edamalaipattipudur Post,Panjappur Village, Srirangam Taluk, Tiruchirappalli-620012.",EC,ELECTRONICS ANDCOMMUNICATIONENGINEERING,70,72,2
3819,"Saranathan College of Engineering (Autonomous),Venkateswara Nagar, Edamalaipattipudur Post,Panjappur Village, Srirangam Taluk, Tiruchirappalli-620012.",EE,ELECTRICAL AND ELECTRONICSENGINEERING,36,35,-1
3819,"Saranathan College of Engineering (Autonomous),Venkateswara Nagar, Edamalaipattipudur Post,Panjappur Village, Srirangam Taluk, Tiruchirappalli-620012.",IC,INSTRUMENTATION ANDCONTROL ENGINEERING,18,18,0
3819,"Saranathan College of Engineering (Autonomous),Venkateswara Nagar, Edamalaipattipudur Post,Panjappur Village, Srirangam Taluk, Tiruchirappalli-620012.",IT,INFORMATION TECHNOLOGY,35,37,2
3819,"Saranathan College of Engineering (Autonomous),Venkateswara Nagar, Edamalaipattipudur Post,Panjappur Village, Srirangam Taluk, Tiruchirappalli-620012.",ME,MECHANICAL ENGINEERING,36,35,-1
3820,"Trichy Engineering College, somu Nagr,Konalai,Tiruchirappalli-621132.",AD,Artificial Intelligence and DataScience,49,42,-7
3820,"Trichy Engineering College, somu Nagr,Konalai,Tiruchirappalli-621132.",AM,COMPUTER SCIENCE ANDENGINEERING (AI ANDMACHINE LEARNING),21,22,1
3820,"Trichy Engineering College, somu Nagr,Konalai,Tiruchirappalli-621132.",CE,CIVIL  ENGINEERING,24,24,0
3820,"Trichy Engineering College, somu Nagr,Konalai,Tiruchirappalli-621132.",CS,COMPUTER SCIENCE ANDENGINEERING,66,63,-3
3820,"Trichy Engineering College, somu Nagr,Konalai,Tiruchirappalli-621132.",EC,ELECTRONICS ANDCOMMUNICATIONENGINEERING,22,23,1
3820,"Trichy Engineering College, somu Nagr,Konalai,Tiruchirappalli-621132.",EE,ELECTRICAL AND ELECTRONICSENGINEERING,49,50,1
3820,Trichy Engineering College  Konalai  TiruchirappalliDistrict 621132,MC,MECHATRONICS,49,0,-49
3820,"Trichy Engineering College, somu Nagr,Konalai,Tiruchirappalli-621132.",ME,MECHANICAL ENGINEERING,49,49,0
3820,"Trichy Engineering College, somu Nagr,Konalai,Tiruchirappalli-621132.",MZ,Mechatronics Engineering,0,48,48
3821,"A.R.J College of Engineering and Technology,Thirumakkottai Main Road, Edayarnatham Village,Sundarakkottai (PO), Mannargudi Taluk, Thiruvarur-614001.",AD,Artificial Intelligence and DataScience,22,50,28
3821,"A.R.J College of Engineering and Technology,Thirumakkottai Main Road, Edayarnatham Village,Sundarakkottai (PO), Mannargudi Taluk, Thiruvarur-614001.",AG,AGRICULTURE ENGINEERING,41,45,4
3821,"A.R.J College of Engineering and Technology,Thirumakkottai Main Road, Edayarnatham Village,Sundarakkottai (PO), Mannargudi Taluk, Thiruvarur-614001.",BM,BIO MEDICAL ENGINEERING,36,45,9
3821,"A.R.J College of Engineering and Technology,Thirumakkottai Main Road, Edayarnatham Village,Sundarakkottai (PO), Mannargudi Taluk, Thiruvarur-614001.",CE,CIVIL  ENGINEERING,23,24,1
3821,"A.R.J College of Engineering and Technology,Thirumakkottai Main Road, Edayarnatham Village,Sundarakkottai (PO), Mannargudi Taluk, Thiruvarur-614001.",CS,COMPUTER SCIENCE ANDENGINEERING,68,68,0
3821,"A.R.J College of Engineering and Technology,Thirumakkottai Main Road, Edayarnatham Village,Sundarakkottai (PO), Mannargudi Taluk, Thiruvarur-614001.",EC,ELECTRONICS ANDCOMMUNICATIONENGINEERING,45,46,1
3821,"A.R.J College of Engineering and Technology,Thirumakkottai Main Road, Edayarnatham Village,Sundarakkottai (PO), Mannargudi Taluk, Thiruvarur-614001.",EE,ELECTRICAL AND ELECTRONICSENGINEERING,22,22,0
3821,"A.R.J College of Engineering and Technology,Thirumakkottai Main Road, Edayarnatham Village,Sundarakkottai (PO), Mannargudi Taluk, Thiruvarur-614001.",ME,MECHANICAL ENGINEERING,46,24,-22
3822,"Dr.Navalar Nedunchezhiyan College of Engineering,Raja Nagar, Vaithiyanathapuram, Tholudur,Cuddalore-606303.",AD,Artificial Intelligence and DataScience,27,27,0
3822,"Dr.Navalar Nedunchezhiyan College of Engineering,Raja Nagar, Vaithiyanathapuram, Tholudur,Cuddalore-606303.",BM,BIO MEDICAL ENGINEERING,26,26,0
3822,"Dr.Navalar Nedunchezhiyan College of Engineering,Raja Nagar, Vaithiyanathapuram, Tholudur,Cuddalore-606303.",CE,CIVIL  ENGINEERING,17,25,8
3822,"Dr.Navalar Nedunchezhiyan College of Engineering,Raja Nagar, Vaithiyanathapuram, Tholudur,Cuddalore-606303.",CS,COMPUTER SCIENCE ANDENGINEERING,50,49,-1
3822,"Dr.Navalar Nedunchezhiyan College of Engineering,Raja Nagar, Vaithiyanathapuram, Tholudur,Cuddalore-606303.",EC,ELECTRONICS ANDCOMMUNICATIONENGINEERING,27,26,-1
3822,"Dr.Navalar Nedunchezhiyan College of Engineering,Raja Nagar, Vaithiyanathapuram, Tholudur,Cuddalore-606303.",EE,ELECTRICAL AND ELECTRONICSENGINEERING,35,50,15
3822,"Dr.Navalar Nedunchezhiyan College of Engineering,Raja Nagar, Vaithiyanathapuram, Tholudur,Cuddalore-606303.",IT,INFORMATION TECHNOLOGY,26,26,0
3822,"Dr.Navalar Nedunchezhiyan College of Engineering,Raja Nagar, Vaithiyanathapuram, Tholudur,Cuddalore-606303.",ME,MECHANICAL ENGINEERING,35,49,14
3825,"St. Joseph's College of Engineering and Technology,A.S.Nagar, Ellupatti, Rawasapatti Post, InathukanpattiVillage, Thanjavur-613403.",AD,Artificial Intelligence and DataScience,45,41,-4
3825,"St. Joseph's College of Engineering and Technology,A.S.Nagar, Ellupatti, Rawasapatti Post, InathukanpattiVillage, Thanjavur-613403.",CS,COMPUTER SCIENCE ANDENGINEERING,90,100,10
3825,"St. Joseph's College of Engineering and Technology,A.S.Nagar, Ellupatti, Rawasapatti Post, InathukanpattiVillage, Thanjavur-613403.",EC,ELECTRONICS ANDCOMMUNICATIONENGINEERING,41,45,4
3825,"St. Joseph's College of Engineering and Technology,A.S.Nagar, Ellupatti, Rawasapatti Post, InathukanpattiVillage, Thanjavur-613403.",EE,ELECTRICAL AND ELECTRONICSENGINEERING,27,28,1
3825,"St. Joseph's College of Engineering and Technology,A.S.Nagar, Ellupatti, Rawasapatti Post, InathukanpattiVillage, Thanjavur-613403.",IT,INFORMATION TECHNOLOGY,0,45,45
3825,"St. Joseph's College of Engineering and Technology,A.S.Nagar, Ellupatti, Rawasapatti Post, InathukanpattiVillage, Thanjavur-613403.",ME,MECHANICAL ENGINEERING,27,27,0
3826,"Kongunadu College of Engineering and Technology(Autonomous), Tholurpatti, Thottiam, Tiruchirappalli-621215.",AD,Artificial Intelligence and DataScience,35,70,35
3826,"Kongunadu College of Engineering and Technology(Autonomous), Tholurpatti, Thottiam, Tiruchirappalli-621215.",AG,AGRICULTURE ENGINEERING,35,44,9
3826,"Kongunadu College of Engineering and Technology(Autonomous), Tholurpatti, Thottiam, Tiruchirappalli-621215.",BM,BIO MEDICAL ENGINEERING,35,45,10
3826,"Kongunadu College of Engineering and Technology(Autonomous), Tholurpatti, Thottiam, Tiruchirappalli-621215.",CE,CIVIL  ENGINEERING,35,40,5
3826,"Kongunadu College of Engineering and Technology(Autonomous), Tholurpatti, Thottiam, Tiruchirappalli-621215.",CS,COMPUTER SCIENCE ANDENGINEERING,70,107,37
3826,"Kongunadu College of Engineering and Technology(Autonomous), Tholurpatti, Thottiam, Tiruchirappalli-621215.",EC,ELECTRONICS ANDCOMMUNICATIONENGINEERING,71,70,-1
3826,"Kongunadu College of Engineering and Technology(Autonomous), Tholurpatti, Thottiam, Tiruchirappalli-621215.",EE,ELECTRICAL AND ELECTRONICSENGINEERING,35,36,1
3826,"Kongunadu College of Engineering and Technology(Autonomous), Tholurpatti, Thottiam, Tiruchirappalli-621215.",IT,INFORMATION TECHNOLOGY,35,35,0
3826,"Kongunadu College of Engineering and Technology(Autonomous), Tholurpatti, Thottiam, Tiruchirappalli-621215.",ME,MECHANICAL ENGINEERING,72,79,7
3829,"M.A.M. College of Engineering and Technology, TrichyChennai Trunk Road, Siruganur, Manachanallur Taluk,Tiruchirappalli-621105.",AD,Artificial Intelligence and DataScience,32,32,0
3829,"M.A.M. College of Engineering and Technology, TrichyChennai Trunk Road, Siruganur, Manachanallur Taluk,Tiruchirappalli-621105.",CE,CIVIL  ENGINEERING,14,14,0
3829,"M.A.M. College of Engineering and Technology, TrichyChennai Trunk Road, Siruganur, Manachanallur Taluk,Tiruchirappalli-621105.",CS,COMPUTER SCIENCE ANDENGINEERING,55,77,22
3829,"M.A.M. College of Engineering and Technology, TrichyChennai Trunk Road, Siruganur, Manachanallur Taluk,Tiruchirappalli-621105.",EC,ELECTRONICS ANDCOMMUNICATIONENGINEERING,44,45,1
3829,"M.A.M. College of Engineering and Technology, TrichyChennai Trunk Road, Siruganur, Manachanallur Taluk,Tiruchirappalli-621105.",EE,ELECTRICAL AND ELECTRONICSENGINEERING,36,36,0
3829,"M.A.M. College of Engineering and Technology, TrichyChennai Trunk Road, Siruganur, Manachanallur Taluk,Tiruchirappalli-621105.",IT,INFORMATION TECHNOLOGY,36,36,0
3829,"M.A.M. College of Engineering and Technology, TrichyChennai Trunk Road, Siruganur, Manachanallur Taluk,Tiruchirappalli-621105.",ME,MECHANICAL ENGINEERING,27,23,-4
3830,"K. Ramakrishnan College of Engineering(Autonomous), Kariyamanickam Road, Samayapuram,Tiruchirappalli-621112.",AD,Artificial Intelligence and DataScience,35,71,36
3830,"K. Ramakrishnan College of Engineering(Autonomous), Kariyamanickam Road, Samayapuram,Tiruchirappalli-621112.",AM,COMPUTER SCIENCE ANDENGINEERING (AI ANDMACHINE LEARNING),34,36,2
3830,"K. Ramakrishnan College of Engineering(Autonomous), Kariyamanickam Road, Samayapuram,Tiruchirappalli-621112.",CB,COMPUTER SCIENCE ANDBUSSINESS SYSTEM,35,36,1
3830,"K. Ramakrishnan College of Engineering(Autonomous), Kariyamanickam Road, Samayapuram,Tiruchirappalli-621112.",CS,COMPUTER SCIENCE ANDENGINEERING,70,70,0
3830,"K. Ramakrishnan College of Engineering(Autonomous), Kariyamanickam Road, Samayapuram,Tiruchirappalli-621112.",EC,ELECTRONICS ANDCOMMUNICATIONENGINEERING,71,70,-1
3830,"K. Ramakrishnan College of Engineering(Autonomous), Kariyamanickam Road, Samayapuram,Tiruchirappalli-621112.",EE,ELECTRICAL AND ELECTRONICSENGINEERING,35,36,1
3830,"K. Ramakrishnan College of Engineering(Autonomous), Kariyamanickam Road, Samayapuram,Tiruchirappalli-621112.",IT,INFORMATION TECHNOLOGY,71,70,-1
3830,"K. Ramakrishnan College of Engineering(Autonomous), Kariyamanickam Road, Samayapuram,Tiruchirappalli-621112.",ME,MECHANICAL ENGINEERING,35,36,1
3831,"Indra Ganesan College of Engineering, Madurai MainRoad, Manikandam, Tiruchirappalli-620012.",AD,Artificial Intelligence and DataScience,45,46,1
3831,"Indra Ganesan College of Engineering, Madurai MainRoad, Manikandam, Tiruchirappalli-620012.",AG,AGRICULTURE ENGINEERING,55,54,-1
3831,"Indra Ganesan College of Engineering, Madurai MainRoad, Manikandam, Tiruchirappalli-620012.",BM,BIO MEDICAL ENGINEERING,54,54,0
3831,"Indra Ganesan College of Engineering, Madurai MainRoad, Manikandam, Tiruchirappalli-620012.",CS,COMPUTER SCIENCE ANDENGINEERING,45,108,63
3831,"Indra Ganesan College of Engineering, Madurai MainRoad, Manikandam, Tiruchirappalli-620012.",EC,ELECTRONICS ANDCOMMUNICATIONENGINEERING,54,55,1
3831,"Indra Ganesan College of Engineering, Madurai MainRoad, Manikandam, Tiruchirappalli-620012.",EE,ELECTRICAL AND ELECTRONICSENGINEERING,27,28,1
3831,"Indra Ganesan College of Engineering, Madurai MainRoad, Manikandam, Tiruchirappalli-620012.",IT,INFORMATION TECHNOLOGY,45,108,63
3831,"Indra Ganesan College of Engineering, Madurai MainRoad, Manikandam, Tiruchirappalli-620012.",ME,MECHANICAL ENGINEERING,27,27,0
3833,"Parisutham Institute of Technology and Science(Autonomous), NH 67 Ring Road, Nanjikottai,Thanjavur-613006.",AE,AERONAUTICAL ENGINEERING,18,24,6
3833,"Parisutham Institute of Technology and Science(Autonomous), NH 67 Ring Road, Nanjikottai,Thanjavur-613006.",CE,CIVIL  ENGINEERING,14,24,10
3833,"Parisutham Institute of Technology and Science(Autonomous), NH 67 Ring Road, Nanjikottai,Thanjavur-613006.",CS,COMPUTER SCIENCE ANDENGINEERING,72,91,19
3833,"Parisutham Institute of Technology and Science(Autonomous), NH 67 Ring Road, Nanjikottai,Thanjavur-613006.",EC,ELECTRONICS ANDCOMMUNICATIONENGINEERING,26,45,19
3833,"Parisutham Institute of Technology and Science(Autonomous), NH 67 Ring Road, Nanjikottai,Thanjavur-613006.",EE,ELECTRICAL AND ELECTRONICSENGINEERING,14,25,11
3833,"Parisutham Institute of Technology and Science(Autonomous), NH 67 Ring Road, Nanjikottai,Thanjavur-613006.",IT,INFORMATION TECHNOLOGY,36,45,9
3833,"Parisutham Institute of Technology and Science(Autonomous), NH 67 Ring Road, Nanjikottai,Thanjavur-613006.",ME,MECHANICAL ENGINEERING,14,25,11
3841,"CARE College of Engineering (Autonomous), No.27,Thayanoor village, Kuttapatti, Tiruchirappalli-620009.",AD,Artificial Intelligence and DataScience,72,71,-1
3841,"CARE College of Engineering (Autonomous), No.27,Thayanoor village, Kuttapatti, Tiruchirappalli-620009.",CE,CIVIL  ENGINEERING,24,16,-8
3841,"CARE College of Engineering (Autonomous), No.27,Thayanoor village, Kuttapatti, Tiruchirappalli-620009.",CS,COMPUTER SCIENCE ANDENGINEERING,70,71,1
3841,"CARE College of Engineering (Autonomous), No.27,Thayanoor village, Kuttapatti, Tiruchirappalli-620009.",DA,Bachelor of Design,0,18,18
3841,"CARE College of Engineering (Autonomous), No.27,Thayanoor village, Kuttapatti, Tiruchirappalli-620009.",EC,ELECTRONICS ANDCOMMUNICATIONENGINEERING,44,35,-9
3841,"CARE College of Engineering (Autonomous), No.27,Thayanoor village, Kuttapatti, Tiruchirappalli-620009.",ME,MECHANICAL ENGINEERING,25,19,-6
3843,"MRK Institute of Technology, Nattarmangalam Post,Kattumannarkoil, Cuddalore-608301.",AD,Artificial Intelligence and DataScience,0,19,19
3843,"MRK Institute of Technology, Nattarmangalam Post,Kattumannarkoil, Cuddalore-608301.",AM,COMPUTER SCIENCE ANDENGINEERING (AI ANDMACHINE LEARNING),0,18,18
3843,"MRK Institute of Technology, Nattarmangalam Post,Kattumannarkoil, Cuddalore-608301.",CE,CIVIL  ENGINEERING,24,23,-1
3843,"MRK Institute of Technology, Nattarmangalam Post,Kattumannarkoil, Cuddalore-608301.",CS,COMPUTER SCIENCE ANDENGINEERING,54,53,-1
3843,"MRK Institute of Technology, Nattarmangalam Post,Kattumannarkoil, Cuddalore-608301.",EC,ELECTRONICS ANDCOMMUNICATIONENGINEERING,58,65,7
3843,"MRK Institute of Technology, Nattarmangalam Post,Kattumannarkoil, Cuddalore-608301.",EE,ELECTRICAL AND ELECTRONICSENGINEERING,40,21,-19
3843,"MRK Institute of Technology, Nattarmangalam Post,Kattumannarkoil, Cuddalore-608301.",IT,INFORMATION TECHNOLOGY,34,35,1
3843,"MRK Institute of Technology, Nattarmangalam Post,Kattumannarkoil, Cuddalore-608301.",ME,MECHANICAL ENGINEERING,50,44,-6
3844,"Shivani Engineering College, Poolangulathupatti(Post), Srirangam (Taluk), Tiruchirappalli-620009.",AD,Artificial Intelligence and DataScience,35,36,1
3844,"Shivani Engineering College, Poolangulathupatti(Post), Srirangam (Taluk), Tiruchirappalli-620009.",BM,BIO MEDICAL ENGINEERING,35,35,0
3844,"Shivani Engineering College, Poolangulathupatti(Post), Srirangam (Taluk), Tiruchirappalli-620009.",CS,COMPUTER SCIENCE ANDENGINEERING,34,35,1
3844,"Shivani Engineering College, Poolangulathupatti(Post), Srirangam (Taluk), Tiruchirappalli-620009.",EC,ELECTRONICS ANDCOMMUNICATIONENGINEERING,35,18,-17
3844,"Shivani Engineering College, Poolangulathupatti(Post), Srirangam (Taluk), Tiruchirappalli-620009.",EE,ELECTRICAL AND ELECTRONICSENGINEERING,19,18,-1
3844,"Shivani Engineering College, Poolangulathupatti(Post), Srirangam (Taluk), Tiruchirappalli-620009.",IT,INFORMATION TECHNOLOGY,0,35,35
3844,"Shivani Engineering College, Poolangulathupatti(Post), Srirangam (Taluk), Tiruchirappalli-620009.",ME,MECHANICAL ENGINEERING,35,17,-18
3844,"Shivani Engineering College, Poolangulathupatti(Post), Srirangam (Taluk), Tiruchirappalli-620009.",SC,Computer Science andEngineering (Cyber Security),18,18,0
3845,"Imayam College of Engineering, Kannanur Post,Thuraiyur Taluk, Tiruchirappalli-621206.",AD,Artificial Intelligence and DataScience,35,35,0
3845,"Imayam College of Engineering, Kannanur Post,Thuraiyur Taluk, Tiruchirappalli-621206.",AM,COMPUTER SCIENCE ANDENGINEERING (AI ANDMACHINE LEARNING),18,23,5
3845,"Imayam College of Engineering, Kannanur Post,Thuraiyur Taluk, Tiruchirappalli-621206.",CS,COMPUTER SCIENCE ANDENGINEERING,35,36,1
3845,"Imayam College of Engineering, Kannanur Post,Thuraiyur Taluk, Tiruchirappalli-621206.",EC,ELECTRONICS ANDCOMMUNICATIONENGINEERING,35,49,14
3845,"Imayam College of Engineering, Kannanur Post,Thuraiyur Taluk, Tiruchirappalli-621206.",EE,ELECTRICAL AND ELECTRONICSENGINEERING,18,21,3
3845,"Imayam College of Engineering, Kannanur Post,Thuraiyur Taluk, Tiruchirappalli-621206.",ME,MECHANICAL ENGINEERING,43,49,6
3845,"Imayam College of Engineering, Kannanur Post,Thuraiyur Taluk, Tiruchirappalli-621206.",SC,Computer Science andEngineering (Cyber Security),18,17,-1
3846,"Mother Terasa College of Engineering andTechnology, Mettusalai, Illuppur (Post & Taluk),Pudukkottai District-622102.",AD,Artificial Intelligence and DataScience,46,50,4
3846,"Mother Terasa College of Engineering andTechnology, Mettusalai, Illuppur (Post & Taluk),Pudukkottai District-622102.",CB,COMPUTER SCIENCE ANDBUSSINESS SYSTEM,44,50,6
3846,"Mother Terasa College of Engineering andTechnology, Mettusalai, Illuppur (Post & Taluk),Pudukkottai District-622102.",CE,CIVIL  ENGINEERING,45,53,8
3846,"Mother Terasa College of Engineering andTechnology, Mettusalai, Illuppur (Post & Taluk),Pudukkottai District-622102.",CS,COMPUTER SCIENCE ANDENGINEERING,45,50,5
3846,"Mother Terasa College of Engineering andTechnology, Mettusalai, Illuppur (Post & Taluk),Pudukkottai District-622102.",EC,ELECTRONICS ANDCOMMUNICATIONENGINEERING,23,28,5
3846,"Mother Terasa College of Engineering andTechnology, Mettusalai, Illuppur (Post & Taluk),Pudukkottai District-622102.",EE,ELECTRICAL AND ELECTRONICSENGINEERING,45,54,9
3846,"Mother Terasa College of Engineering andTechnology, Mettusalai, Illuppur (Post & Taluk),Pudukkottai District-622102.",ME,MECHANICAL ENGINEERING,46,54,8
3846,Mother Terasa College of Engineering and TechnologyMettusalai Post and Taluk  Pudukkottai District 622102,RM,ROBOTICS AND AUTOMATION,23,0,-23
3848,"Vandayar Engineering College, Pulavarnatham (Post),Mariammankovil (via), Nagai Main Road, Thanjavur-613501.",AD,Artificial Intelligence and DataScience,0,49,49
3848,"Vandayar Engineering College, Pulavarnatham (Post),Mariammankovil (via), Nagai Main Road, Thanjavur-613501.",CE,CIVIL  ENGINEERING,55,23,-32
3848,"Vandayar Engineering College, Pulavarnatham (Post),Mariammankovil (via), Nagai Main Road, Thanjavur-613501.",CS,COMPUTER SCIENCE ANDENGINEERING,55,50,-5
3848,"Vandayar Engineering College, Pulavarnatham (Post),Mariammankovil (via), Nagai Main Road, Thanjavur-613501.",EC,ELECTRONICS ANDCOMMUNICATIONENGINEERING,26,25,-1
3848,"Vandayar Engineering College, Pulavarnatham (Post),Mariammankovil (via), Nagai Main Road, Thanjavur-613501.",EE,ELECTRICAL AND ELECTRONICSENGINEERING,28,23,-5
3848,"Vandayar Engineering College, Pulavarnatham (Post),Mariammankovil (via), Nagai Main Road, Thanjavur-613501.",IT,INFORMATION TECHNOLOGY,0,49,49
3848,"Vandayar Engineering College, Pulavarnatham (Post),Mariammankovil (via), Nagai Main Road, Thanjavur-613501.",ME,MECHANICAL ENGINEERING,84,45,-39
3849,"Annai College of Engineering and Technology,Anakudi Road, Kovilacheri, Kumbakonam, ThanjavurDistrict-612503.",AD,Artificial Intelligence and DataScience,0,50,50
3849,"Annai College of Engineering and Technology,Anakudi Road, Kovilacheri, Kumbakonam, ThanjavurDistrict-612503.",CE,CIVIL  ENGINEERING,108,104,-4
3849,"Annai College of Engineering and Technology,Anakudi Road, Kovilacheri, Kumbakonam, ThanjavurDistrict-612503.",CS,COMPUTER SCIENCE ANDENGINEERING,50,50,0
3849,"Annai College of Engineering and Technology,Anakudi Road, Kovilacheri, Kumbakonam, ThanjavurDistrict-612503.",EC,ELECTRONICS ANDCOMMUNICATIONENGINEERING,108,104,-4
3849,"Annai College of Engineering and Technology,Anakudi Road, Kovilacheri, Kumbakonam, ThanjavurDistrict-612503.",EE,ELECTRICAL AND ELECTRONICSENGINEERING,55,50,-5
3849,"Annai College of Engineering and Technology,Anakudi Road, Kovilacheri, Kumbakonam, ThanjavurDistrict-612503.",IT,INFORMATION TECHNOLOGY,50,50,0
3849,"Annai College of Engineering and Technology,Anakudi Road, Kovilacheri, Kumbakonam, ThanjavurDistrict-612503.",ME,MECHANICAL ENGINEERING,109,104,-5
3850,"Vetri Vinayaha College of Engineering andTechnology, Tholurpatti, Thottiam, Tiruchirappalli-621215.",AD,Artificial Intelligence and DataScience,35,54,19
3850,"Vetri Vinayaha College of Engineering andTechnology, Tholurpatti, Thottiam, Tiruchirappalli-621215.",CS,COMPUTER SCIENCE ANDENGINEERING,35,55,20
3850,"Vetri Vinayaha College of Engineering andTechnology, Tholurpatti, Thottiam, Tiruchirappalli-621215.",EC,ELECTRONICS ANDCOMMUNICATIONENGINEERING,17,28,11
3850,"Vetri Vinayaha College of Engineering andTechnology, Tholurpatti, Thottiam, Tiruchirappalli-621215.",EE,ELECTRICAL AND ELECTRONICSENGINEERING,18,26,8
3850,"Vetri Vinayaha College of Engineering andTechnology, Tholurpatti, Thottiam, Tiruchirappalli-621215.",IT,INFORMATION TECHNOLOGY,18,28,10
3850,"Vetri Vinayaha College of Engineering andTechnology, Tholurpatti, Thottiam, Tiruchirappalli-621215.",ME,MECHANICAL ENGINEERING,19,26,7
3852,"Sri Bharathi Engineering College for Women,Aranthangi Road, Kaikurichi, Alangudi Taluk,Pudukkottai-622303.",CE,CIVIL  ENGINEERING,52,51,-1
3852,"Sri Bharathi Engineering College for Women,Aranthangi Road, Kaikurichi, Alangudi Taluk,Pudukkottai-622303.",CS,COMPUTER SCIENCE ANDENGINEERING,52,52,0
3852,"Sri Bharathi Engineering College for Women,Aranthangi Road, Kaikurichi, Alangudi Taluk,Pudukkottai-622303.",EC,ELECTRONICS ANDCOMMUNICATIONENGINEERING,51,52,1
3852,"Sri Bharathi Engineering College for Women,Aranthangi Road, Kaikurichi, Alangudi Taluk,Pudukkottai-622303.",EE,ELECTRICAL AND ELECTRONICSENGINEERING,27,28,1
3852,"Sri Bharathi Engineering College for Women,Aranthangi Road, Kaikurichi, Alangudi Taluk,Pudukkottai-622303.",IT,INFORMATION TECHNOLOGY,52,51,-1
3854,"Mahath Amma Institute of Engineering andTechnology, Ariyur, Mathiyanaloor-Post, AnnavasalRoad, Illupur Taluk, Pudukkottai-622101.",AD,Artificial Intelligence and DataScience,27,27,0
3854,"Mahath Amma Institute of Engineering andTechnology, Ariyur, Mathiyanaloor-Post, AnnavasalRoad, Illupur Taluk, Pudukkottai-622101.",AG,AGRICULTURE ENGINEERING,55,55,0
3854,"Mahath Amma Institute of Engineering andTechnology, Ariyur, Mathiyanaloor-Post, AnnavasalRoad, Illupur Taluk, Pudukkottai-622101.",CE,CIVIL  ENGINEERING,27,27,0
3854,"Mahath Amma Institute of Engineering andTechnology, Ariyur, Mathiyanaloor-Post, AnnavasalRoad, Illupur Taluk, Pudukkottai-622101.",CS,COMPUTER SCIENCE ANDENGINEERING,54,55,1
3854,"Mahath Amma Institute of Engineering andTechnology, Ariyur, Mathiyanaloor-Post, AnnavasalRoad, Illupur Taluk, Pudukkottai-622101.",EE,ELECTRICAL AND ELECTRONICSENGINEERING,55,54,-1
3854,"Mahath Amma Institute of Engineering andTechnology, Ariyur, Mathiyanaloor-Post, AnnavasalRoad, Illupur Taluk, Pudukkottai-622101.",IT,INFORMATION TECHNOLOGY,28,27,-1
3854,"Mahath Amma Institute of Engineering andTechnology, Ariyur, Mathiyanaloor-Post, AnnavasalRoad, Illupur Taluk, Pudukkottai-622101.",ME,MECHANICAL ENGINEERING,54,54,0
3854,"Mahath Amma Institute of Engineering andTechnology, Ariyur, Mathiyanaloor-Post, AnnavasalRoad, Illupur Taluk, Pudukkottai-622101.",SC,Computer Science andEngineering (Cyber Security),27,27,0
3855,"As-Salam College of Engineering and Technology,Thirumangalakudi-Aduthurai, Thiruvidaimaruthur,Thanjavur-612102.",AD,Artificial Intelligence and DataScience,18,28,10
3855,"As-Salam College of Engineering and Technology,Thirumangalakudi-Aduthurai, Thiruvidaimaruthur,Thanjavur-612102.",CE,CIVIL  ENGINEERING,20,28,8
3855,"As-Salam College of Engineering and Technology,Thirumangalakudi-Aduthurai, Thiruvidaimaruthur,Thanjavur-612102.",CS,COMPUTER SCIENCE ANDENGINEERING,34,54,20
3855,"As-Salam College of Engineering and Technology,Thirumangalakudi-Aduthurai, Thiruvidaimaruthur,Thanjavur-612102.",EC,ELECTRONICS ANDCOMMUNICATIONENGINEERING,41,54,13
3855,"As-Salam College of Engineering and Technology,Thirumangalakudi-Aduthurai, Thiruvidaimaruthur,Thanjavur-612102.",EE,ELECTRICAL AND ELECTRONICSENGINEERING,41,54,13
3855,"As-Salam College of Engineering and Technology,Thirumangalakudi-Aduthurai, Thiruvidaimaruthur,Thanjavur-612102.",IT,INFORMATION TECHNOLOGY,18,19,1
3855,"As-Salam College of Engineering and Technology,Thirumangalakudi-Aduthurai, Thiruvidaimaruthur,Thanjavur-612102.",ME,MECHANICAL ENGINEERING,40,53,13
3855,"As-Salam College of Engineering and Technology,Thirumangalakudi-Aduthurai, Thiruvidaimaruthur,Thanjavur-612102.",SC,Computer Science andEngineering (Cyber Security),18,27,9
3857,"Meenakshi Ramaswamy Engineering College,M.R.Kalvi Nagar, Thathanur Post, UdayarpalayamTaluk, Ariyalur District-621804.",AG,AGRICULTURE ENGINEERING,27,28,1
3857,"Meenakshi Ramaswamy Engineering College,M.R.Kalvi Nagar, Thathanur Post, UdayarpalayamTaluk, Ariyalur District-621804.",AM,COMPUTER SCIENCE ANDENGINEERING (AI ANDMACHINE LEARNING),26,54,28
3857,"Meenakshi Ramaswamy Engineering College,M.R.Kalvi Nagar, Thathanur Post, UdayarpalayamTaluk, Ariyalur District-621804.",BM,BIO MEDICAL ENGINEERING,28,28,0
3857,"Meenakshi Ramaswamy Engineering College,M.R.Kalvi Nagar, Thathanur Post, UdayarpalayamTaluk, Ariyalur District-621804.",CE,CIVIL  ENGINEERING,28,28,0
3857,"Meenakshi Ramaswamy Engineering College,M.R.Kalvi Nagar, Thathanur Post, UdayarpalayamTaluk, Ariyalur District-621804.",CS,COMPUTER SCIENCE ANDENGINEERING,55,54,-1
3857,"Meenakshi Ramaswamy Engineering College,M.R.Kalvi Nagar, Thathanur Post, UdayarpalayamTaluk, Ariyalur District-621804.",EC,ELECTRONICS ANDCOMMUNICATIONENGINEERING,27,28,1
3857,"Meenakshi Ramaswamy Engineering College,M.R.Kalvi Nagar, Thathanur Post, UdayarpalayamTaluk, Ariyalur District-621804.",EE,ELECTRICAL AND ELECTRONICSENGINEERING,54,53,-1
3857,"Meenakshi Ramaswamy Engineering College,M.R.Kalvi Nagar, Thathanur Post, UdayarpalayamTaluk, Ariyalur District-621804.",ME,MECHANICAL ENGINEERING,81,54,-27
3859,Sembodai Rukmani Varatharajan Engineering CollegeSembodai Village  Vedaraniam  Nagappattinam District614820,CE,CIVIL  ENGINEERING,14,0,-14
3859,Sembodai Rukmani Varatharajan Engineering CollegeSembodai Village  Vedaraniam  Nagappattinam District614820,CS,COMPUTER SCIENCE ANDENGINEERING,27,0,-27
3859,Sembodai Rukmani Varatharajan Engineering CollegeSembodai Village  Vedaraniam  Nagappattinam District614820,EC,ELECTRONICS ANDCOMMUNICATIONENGINEERING,14,0,-14
3859,Sembodai Rukmani Varatharajan Engineering CollegeSembodai Village  Vedaraniam  Nagappattinam District614820,EE,ELECTRICAL ANDELECTRONICS ENGINEERING,27,0,-27
3859,Sembodai Rukmani Varatharajan Engineering CollegeSembodai Village  Vedaraniam  Nagappattinam District614820,ME,MECHANICAL ENGINEERING,54,0,-54
3860,"St.Anne's College of Engineering and Technology,Anguchettypalayam, Siruvathur Post, Panruti Taluk,Cuddalore District-607110.",AM,COMPUTER SCIENCE ANDENGINEERING (AI ANDMACHINE LEARNING),49,49,0
3860,"St.Anne's College of Engineering and Technology,Anguchettypalayam, Siruvathur Post, Panruti Taluk,Cuddalore District-607110.",CS,COMPUTER SCIENCE ANDENGINEERING,48,49,1
3860,"St.Anne's College of Engineering and Technology,Anguchettypalayam, Siruvathur Post, Panruti Taluk,Cuddalore District-607110.",EC,ELECTRONICS ANDCOMMUNICATIONENGINEERING,49,49,0
3860,"St.Anne's College of Engineering and Technology,Anguchettypalayam, Siruvathur Post, Panruti Taluk,Cuddalore District-607110.",EE,ELECTRICAL AND ELECTRONICSENGINEERING,49,49,0
3860,"St.Anne's College of Engineering and Technology,Anguchettypalayam, Siruvathur Post, Panruti Taluk,Cuddalore District-607110.",ME,MECHANICAL ENGINEERING,49,49,0
3905,"Kings College of Engineering (Autonomous),Punalkulam Village, Gandarvakkottai Taluk,Pudukkottai District-613303.",AD,Artificial Intelligence and DataScience,19,35,16
3905,"Kings College of Engineering (Autonomous),Punalkulam Village, Gandarvakkottai Taluk,Pudukkottai District-613303.",CE,CIVIL  ENGINEERING,49,23,-26
3905,"Kings College of Engineering (Autonomous),Punalkulam Village, Gandarvakkottai Taluk,Pudukkottai District-613303.",CS,COMPUTER SCIENCE ANDENGINEERING,69,70,1
3905,"Kings College of Engineering (Autonomous),Punalkulam Village, Gandarvakkottai Taluk,Pudukkottai District-613303.",EC,ELECTRONICS ANDCOMMUNICATIONENGINEERING,72,98,26
3905,"Kings College of Engineering (Autonomous),Punalkulam Village, Gandarvakkottai Taluk,Pudukkottai District-613303.",EE,ELECTRICAL AND ELECTRONICSENGINEERING,48,47,-1
3905,"Kings College of Engineering (Autonomous),Punalkulam Village, Gandarvakkottai Taluk,Pudukkottai District-613303.",IT,INFORMATION TECHNOLOGY,0,19,19
3905,"Kings College of Engineering (Autonomous),Punalkulam Village, Gandarvakkottai Taluk,Pudukkottai District-613303.",ME,MECHANICAL ENGINEERING,49,47,-2
3908,"Mount Zion College of Engineering and Technology,Lena vilakku, Pilivalam Post,  Pudukkottai-622507.",AD,Artificial Intelligence and DataScience,18,35,17
3908,"Mount Zion College of Engineering and Technology,Lena vilakku, Pilivalam Post,  Pudukkottai-622507.",CE,CIVIL  ENGINEERING,27,23,-4
3908,"Mount Zion College of Engineering and Technology,Lena vilakku, Pilivalam Post,  Pudukkottai-622507.",CS,COMPUTER SCIENCE ANDENGINEERING,69,71,2
3908,"Mount Zion College of Engineering and Technology,Lena vilakku, Pilivalam Post,  Pudukkottai-622507.",EC,ELECTRONICS ANDCOMMUNICATIONENGINEERING,50,46,-4
3908,"Mount Zion College of Engineering and Technology,Lena vilakku, Pilivalam Post,  Pudukkottai-622507.",EE,ELECTRICAL AND ELECTRONICSENGINEERING,55,49,-6
3908,"Mount Zion College of Engineering and Technology,Lena vilakku, Pilivalam Post,  Pudukkottai-622507.",IT,INFORMATION TECHNOLOGY,18,35,17
3908,"Mount Zion College of Engineering and Technology,Lena vilakku, Pilivalam Post,  Pudukkottai-622507.",ME,MECHANICAL ENGINEERING,27,24,-3
3918,"Shanmuganathan Engineering College, Arasampatti,Pilivalam Post, Thirumayam Taluk, PudukkottaiDistrict-622507.",AM,COMPUTER SCIENCE ANDENGINEERING (AI ANDMACHINE LEARNING),22,23,1
3918,"Shanmuganathan Engineering College, Arasampatti,Pilivalam Post, Thirumayam Taluk, PudukkottaiDistrict-622507.",CE,CIVIL  ENGINEERING,24,24,0
3918,"Shanmuganathan Engineering College, Arasampatti,Pilivalam Post, Thirumayam Taluk, PudukkottaiDistrict-622507.",CS,COMPUTER SCIENCE ANDENGINEERING,45,42,-3
3918,"Shanmuganathan Engineering College, Arasampatti,Pilivalam Post, Thirumayam Taluk, PudukkottaiDistrict-622507.",EC,ELECTRONICS ANDCOMMUNICATIONENGINEERING,49,49,0
3918,"Shanmuganathan Engineering College, Arasampatti,Pilivalam Post, Thirumayam Taluk, PudukkottaiDistrict-622507.",EE,ELECTRICAL AND ELECTRONICSENGINEERING,26,24,-2
3918,"Shanmuganathan Engineering College, Arasampatti,Pilivalam Post, Thirumayam Taluk, PudukkottaiDistrict-622507.",ME,MECHANICAL ENGINEERING,24,24,0
3918,"Shanmuganathan Engineering College, Arasampatti,Pilivalam Post, Thirumayam Taluk, PudukkottaiDistrict-622507.",SC,Computer Science andEngineering (Cyber Security),22,24,2
3920,"Sudharsan Engineering College, Sathiyamangalam,Kulathur Taluk, Pudukkottai District-622501.",AD,Artificial Intelligence and DataScience,44,45,1
3920,"Sudharsan Engineering College, Sathiyamangalam,Kulathur Taluk, Pudukkottai District-622501.",AM,COMPUTER SCIENCE ANDENGINEERING (AI ANDMACHINE LEARNING),49,49,0
3920,"Sudharsan Engineering College, Sathiyamangalam,Kulathur Taluk, Pudukkottai District-622501.",CE,CIVIL  ENGINEERING,21,22,1
3920,"Sudharsan Engineering College, Sathiyamangalam,Kulathur Taluk, Pudukkottai District-622501.",CS,COMPUTER SCIENCE ANDENGINEERING,45,45,0
3920,"Sudharsan Engineering College, Sathiyamangalam,Kulathur Taluk, Pudukkottai District-622501.",EC,ELECTRONICS ANDCOMMUNICATIONENGINEERING,24,23,-1
3920,"Sudharsan Engineering College, Sathiyamangalam,Kulathur Taluk, Pudukkottai District-622501.",EE,ELECTRICAL AND ELECTRONICSENGINEERING,21,21,0
3920,"Sudharsan Engineering College, Sathiyamangalam,Kulathur Taluk, Pudukkottai District-622501.",ME,MECHANICAL ENGINEERING,22,22,0
3923,"MNSK College of Engineering, DhakshinapuramVillage, Vallathirakottai (Post), Alangudi Taluk,Pudukkottai-622305.",AD,Artificial Intelligence and DataScience,18,18,0
3923,"MNSK College of Engineering, DhakshinapuramVillage, Vallathirakottai (Post), Alangudi Taluk,Pudukkottai-622305.",AG,AGRICULTURE ENGINEERING,18,18,0
3923,"MNSK College of Engineering, DhakshinapuramVillage, Vallathirakottai (Post), Alangudi Taluk,Pudukkottai-622305.",CE,CIVIL  ENGINEERING,18,17,-1
3923,"MNSK College of Engineering, DhakshinapuramVillage, Vallathirakottai (Post), Alangudi Taluk,Pudukkottai-622305.",CS,COMPUTER SCIENCE ANDENGINEERING,35,36,1
3923,"MNSK College of Engineering, DhakshinapuramVillage, Vallathirakottai (Post), Alangudi Taluk,Pudukkottai-622305.",EC,ELECTRONICS ANDCOMMUNICATIONENGINEERING,18,18,0
3923,"MNSK College of Engineering, DhakshinapuramVillage, Vallathirakottai (Post), Alangudi Taluk,Pudukkottai-622305.",EE,ELECTRICAL AND ELECTRONICSENGINEERING,18,18,0
3923,"MNSK College of Engineering, DhakshinapuramVillage, Vallathirakottai (Post), Alangudi Taluk,Pudukkottai-622305.",ME,MECHANICAL ENGINEERING,35,35,0
3926,"Chendhuran College of Engineering and Technology,Madurai Main Road, Lena Vilakku, Pilivalam Post,Thirumayam Taluk, Pudukkottai District-622507.",AD,Artificial Intelligence and DataScience,41,40,-1
3926,"Chendhuran College of Engineering and Technology,Madurai Main Road, Lena Vilakku, Pilivalam Post,Thirumayam Taluk, Pudukkottai District-622507.",CE,CIVIL  ENGINEERING,21,21,0
3926,"Chendhuran College of Engineering and Technology,Madurai Main Road, Lena Vilakku, Pilivalam Post,Thirumayam Taluk, Pudukkottai District-622507.",CS,COMPUTER SCIENCE ANDENGINEERING,61,57,-4
3926,"Chendhuran College of Engineering and Technology,Madurai Main Road, Lena Vilakku, Pilivalam Post,Thirumayam Taluk, Pudukkottai District-622507.",EC,ELECTRONICS ANDCOMMUNICATIONENGINEERING,49,49,0
3926,"Chendhuran College of Engineering and Technology,Madurai Main Road, Lena Vilakku, Pilivalam Post,Thirumayam Taluk, Pudukkottai District-622507.",EE,ELECTRICAL AND ELECTRONICSENGINEERING,49,49,0
3926,"Chendhuran College of Engineering and Technology,Madurai Main Road, Lena Vilakku, Pilivalam Post,Thirumayam Taluk, Pudukkottai District-622507.",ME,MECHANICAL ENGINEERING,49,49,0
4020,Anna University Regional Campus - TirunelveliTrivandrum Road  Palayamkottai  Tirunelveli District627007,AD,Artificial Intelligence and DataScience,0,26,26
4020,Anna University Regional Campus - TirunelveliTrivandrum Road  Palayamkottai  Tirunelveli District627007,CS,COMPUTER SCIENCE ANDENGINEERING,52,55,3
4020,Anna University Regional Campus - TirunelveliTrivandrum Road  Palayamkottai  Tirunelveli District627007,EC,ELECTRONICS ANDCOMMUNICATIONENGINEERING,52,55,3
4020,Anna University Regional Campus - TirunelveliTrivandrum Road  Palayamkottai  Tirunelveli District627007,GI,GEO INFORMATICS,55,54,-1
4020,Anna University Regional Campus - TirunelveliTrivandrum Road  Palayamkottai  Tirunelveli District627007,ME,MECHANICAL ENGINEERING,54,54,0
4023,University College of Engineering  NagercoilNagercoil Industrial Estate  Konam  KanyakumariDistrict 629004,CE,CIVIL  ENGINEERING,55,55,0
4023,University College of Engineering  NagercoilNagercoil Industrial Estate  Konam  KanyakumariDistrict 629004,CS,COMPUTER SCIENCE ANDENGINEERING,107,109,2
4023,University College of Engineering  NagercoilNagercoil Industrial Estate  Konam  KanyakumariDistrict 629004,EC,ELECTRONICS ANDCOMMUNICATIONENGINEERING,53,55,2
4023,University College of Engineering  Nagercoil  NagercoilIndustrial Estate  Konam  Kanyakumari District 629004,EE,ELECTRICAL ANDELECTRONICS ENGINEERING,55,0,-55
4023,University College of Engineering  NagercoilNagercoil Industrial Estate  Konam  KanyakumariDistrict 629004,IT,INFORMATION TECHNOLOGY,55,54,-1
4023,University College of Engineering  NagercoilNagercoil Industrial Estate  Konam  KanyakumariDistrict 629004,ME,MECHANICAL ENGINEERING,54,54,0
4023,University College of Engineering  NagercoilNagercoil Industrial Estate  Konam  KanyakumariDistrict 629004,XC,CIVIL ENGINEERING (TAMILMEDIUM),27,27,0
4023,University College of Engineering  NagercoilNagercoil Industrial Estate  Konam  KanyakumariDistrict 629004,XM,MECHANICAL ENGINEERING(TAMIL MEDIUM),27,27,0
4024,University V.O.C. College of Engineering  ThoothukudiNear V.O.C. College  Millerpuram  ThoothukudiDistrict 628008,CE,CIVIL  ENGINEERING,54,55,1
4024,University V.O.C. College of Engineering  ThoothukudiNear V.O.C. College  Millerpuram  ThoothukudiDistrict 628008,EC,ELECTRONICS ANDCOMMUNICATIONENGINEERING,54,53,-1
4024,University V.O.C. College of Engineering  ThoothukudiNear V.O.C. College  Millerpuram  ThoothukudiDistrict 628008,EE,ELECTRICAL AND ELECTRONICSENGINEERING,53,55,2
4024,University V.O.C. College of Engineering  ThoothukudiNear V.O.C. College  Millerpuram  ThoothukudiDistrict 628008,ME,MECHANICAL ENGINEERING,55,54,-1
4024,University V.O.C. College of Engineering  ThoothukudiNear V.O.C. College  Millerpuram  ThoothukudiDistrict 628008,XC,CIVIL ENGINEERING (TAMILMEDIUM),27,28,1
4024,University V.O.C. College of Engineering  ThoothukudiNear V.O.C. College  Millerpuram  ThoothukudiDistrict 628008,XM,MECHANICAL ENGINEERING(TAMIL MEDIUM),28,27,-1
4669,"Thamirabharani Engineering College, Ward - 1,Thatchanallur, Chattiram Puthukullam Village,Vepakullam - Chidhabra Nagar Road, Tirunelveli-627358.",AD,Artificial Intelligence and DataScience,0,54,54
4669,"Thamirabharani Engineering College, Ward - 1,Thatchanallur, Chattiram Puthukullam Village,Vepakullam - Chidhabra Nagar Road, Tirunelveli-627358.",CE,CIVIL  ENGINEERING,28,27,-1
4669,"Thamirabharani Engineering College, Ward - 1,Thatchanallur, Chattiram Puthukullam Village,Vepakullam - Chidhabra Nagar Road, Tirunelveli-627358.",CS,COMPUTER SCIENCE ANDENGINEERING,109,54,-55
4669,"Thamirabharani Engineering College, Ward - 1,Thatchanallur, Chattiram Puthukullam Village,Vepakullam - Chidhabra Nagar Road, Tirunelveli-627358.",EC,ELECTRONICS ANDCOMMUNICATIONENGINEERING,81,53,-28
4669,"Thamirabharani Engineering College, Ward - 1,Thatchanallur, Chattiram Puthukullam Village,Vepakullam - Chidhabra Nagar Road, Tirunelveli-627358.",EE,ELECTRICAL AND ELECTRONICSENGINEERING,27,28,1
4669,"Thamirabharani Engineering College, Ward - 1,Thatchanallur, Chattiram Puthukullam Village,Vepakullam - Chidhabra Nagar Road, Tirunelveli-627358.",ME,MECHANICAL ENGINEERING,27,28,1
4669,"Thamirabharani Engineering College, Ward - 1,Thatchanallur, Chattiram Puthukullam Village,Vepakullam - Chidhabra Nagar Road, Tirunelveli-627358.",SC,Computer Science andEngineering (Cyber Security),0,28,28
4670,"Rohini College of Engineering and Technology(Autonomous), Palkumlam, Variyoor Post,Kanyakumari-629401.",AD,Artificial Intelligence and DataScience,38,35,-3
4670,"Rohini College of Engineering and Technology(Autonomous), Palkumlam, Variyoor Post,Kanyakumari-629401.",AG,AGRICULTURE ENGINEERING,49,49,0
4670,"Rohini College of Engineering and Technology(Autonomous), Palkumlam, Variyoor Post,Kanyakumari-629401.",AM,COMPUTER SCIENCE ANDENGINEERING (AI ANDMACHINE LEARNING),0,35,35
4670,"Rohini College of Engineering and Technology(Autonomous), Palkumlam, Variyoor Post,Kanyakumari-629401.",BM,BIO MEDICAL ENGINEERING,55,35,-20
4670,"Rohini College of Engineering and Technology(Autonomous), Palkumlam, Variyoor Post,Kanyakumari-629401.",CE,CIVIL  ENGINEERING,55,55,0
4670,"Rohini College of Engineering and Technology(Autonomous), Palkumlam, Variyoor Post,Kanyakumari-629401.",CS,COMPUTER SCIENCE ANDENGINEERING,70,70,0
4670,"Rohini College of Engineering and Technology(Autonomous), Palkumlam, Variyoor Post,Kanyakumari-629401.",EC,ELECTRONICS ANDCOMMUNICATIONENGINEERING,35,35,0
4670,"Rohini College of Engineering and Technology(Autonomous), Palkumlam, Variyoor Post,Kanyakumari-629401.",EE,ELECTRICAL AND ELECTRONICSENGINEERING,43,44,1
4670,"Rohini College of Engineering and Technology(Autonomous), Palkumlam, Variyoor Post,Kanyakumari-629401.",ME,MECHANICAL ENGINEERING,35,36,1
4672,"Stella Mary's College of Engineering,Arunthenkanvilai, Azhikal, Kanyakumari-629202.",AD,Artificial Intelligence and DataScience,46,98,52
4672,"Stella Mary's College of Engineering,Arunthenkanvilai, Azhikal, Kanyakumari-629202.",CE,CIVIL  ENGINEERING,35,36,1
4672,"Stella Mary's College of Engineering,Arunthenkanvilai, Azhikal, Kanyakumari-629202.",CS,COMPUTER SCIENCE ANDENGINEERING,91,90,-1
4672,"Stella Mary's College of Engineering,Arunthenkanvilai, Azhikal, Kanyakumari-629202.",EC,ELECTRONICS ANDCOMMUNICATIONENGINEERING,46,47,1
4672,"Stella Mary's College of Engineering,Arunthenkanvilai, Azhikal, Kanyakumari-629202.",EE,ELECTRICAL AND ELECTRONICSENGINEERING,35,47,12
4672,"Stella Mary's College of Engineering,Arunthenkanvilai, Azhikal, Kanyakumari-629202.",ME,MECHANICAL ENGINEERING,35,46,11
4675,"Universal College of Engineering and Technology,Anbagam Campus, Kadambankulam, Villakku,Radhapuram Road, Vallioor, Tirunelveli-627117.",AD,Artificial Intelligence and DataScience,0,28,28
4675,"Universal College of Engineering and Technology,Anbagam Campus, Kadambankulam, Villakku,Radhapuram Road, Vallioor, Tirunelveli-627117.",CB,COMPUTER SCIENCE ANDBUSSINESS SYSTEM,27,27,0
4675,"Universal College of Engineering and Technology,Anbagam Campus, Kadambankulam, Villakku,Radhapuram Road, Vallioor, Tirunelveli-627117.",CE,CIVIL  ENGINEERING,27,27,0
4675,"Universal College of Engineering and Technology,Anbagam Campus, Kadambankulam, Villakku,Radhapuram Road, Vallioor, Tirunelveli-627117.",CS,COMPUTER SCIENCE ANDENGINEERING,54,54,0
4675,"Universal College of Engineering and Technology,Anbagam Campus, Kadambankulam, Villakku,Radhapuram Road, Vallioor, Tirunelveli-627117.",EC,ELECTRONICS ANDCOMMUNICATIONENGINEERING,54,55,1
4675,"Universal College of Engineering and Technology,Anbagam Campus, Kadambankulam, Villakku,Radhapuram Road, Vallioor, Tirunelveli-627117.",EE,ELECTRICAL AND ELECTRONICSENGINEERING,55,28,-27
4675,"Universal College of Engineering and Technology,Anbagam Campus, Kadambankulam, Villakku,Radhapuram Road, Vallioor, Tirunelveli-627117.",ME,MECHANICAL ENGINEERING,54,53,-1
4676,"Renganayagi Varatharaj College of Engineering,Salvarpatti Village & Post, Thayilpatti Via, SivakasiTaluk, Virudhunagar-626128.",AD,Artificial Intelligence and DataScience,35,35,0
4676,"Renganayagi Varatharaj College of Engineering,Salvarpatti Village & Post, Thayilpatti Via, SivakasiTaluk, Virudhunagar-626128.",CS,COMPUTER SCIENCE ANDENGINEERING,70,72,2
4676,"Renganayagi Varatharaj College of Engineering,Salvarpatti Village & Post, Thayilpatti Via, SivakasiTaluk, Virudhunagar-626128.",EC,ELECTRONICS ANDCOMMUNICATIONENGINEERING,35,44,9
4676,"Renganayagi Varatharaj College of Engineering,Salvarpatti Village & Post, Thayilpatti Via, SivakasiTaluk, Virudhunagar-626128.",EE,ELECTRICAL AND ELECTRONICSENGINEERING,18,22,4
4676,"Renganayagi Varatharaj College of Engineering,Salvarpatti Village & Post, Thayilpatti Via, SivakasiTaluk, Virudhunagar-626128.",ME,MECHANICAL ENGINEERING,18,18,0
4677,"Arunachala Hitech Engineering College (formerlyLourdes Mount College of Engineering andTechnology), Marthandam-Karungal Road,Chundavilai Mullanganavilai, Nattalam Post,Nattalam, Kanyakumari -629195.",AD,Artificial Intelligence and DataScience,0,54,54
4677,Lourdes Mount College of Engineering and TechnologyMarthandam-Karungal Road  ChundavilaiMullanganavilai  Nattalam Post  Kanyakumari District629195,CE,CIVIL  ENGINEERING,27,0,-27
4677,"Arunachala Hitech Engineering College (formerlyLourdes Mount College of Engineering andTechnology), Marthandam-Karungal Road,Chundavilai Mullanganavilai, Nattalam Post,Nattalam, Kanyakumari -629195.",CS,COMPUTER SCIENCE ANDENGINEERING,54,109,55
4677,"Arunachala Hitech Engineering College (formerlyLourdes Mount College of Engineering andTechnology), Marthandam-Karungal Road,Chundavilai Mullanganavilai, Nattalam Post,Nattalam, Kanyakumari -629195.",EC,ELECTRONICS ANDCOMMUNICATIONENGINEERING,27,55,28
4677,"Arunachala Hitech Engineering College (formerlyLourdes Mount College of Engineering andTechnology), Marthandam-Karungal Road,Chundavilai Mullanganavilai, Nattalam Post,Nattalam, Kanyakumari -629195.",EE,ELECTRICAL AND ELECTRONICSENGINEERING,27,54,27
4677,"Arunachala Hitech Engineering College (formerlyLourdes Mount College of Engineering andTechnology), Marthandam-Karungal Road,Chundavilai Mullanganavilai, Nattalam Post,Nattalam, Kanyakumari -629195.",IT,INFORMATION TECHNOLOGY,0,55,55
4677,Lourdes Mount College of Engineering and TechnologyMarthandam-Karungal Road  ChundavilaiMullanganavilai  Nattalam Post  Kanyakumari District629195,ME,MECHANICAL ENGINEERING,55,0,-55
4678,"RAMCO Institute of Technology, North VenganallurVillage, Krishnapuram Panchayat, Rajapalayam,Virudhunagar-626117.",AD,Artificial Intelligence and DataScience,71,71,0
4678,"RAMCO Institute of Technology, North VenganallurVillage, Krishnapuram Panchayat, Rajapalayam,Virudhunagar-626117.",CB,COMPUTER SCIENCE ANDBUSSINESS SYSTEM,35,35,0
4678,"RAMCO Institute of Technology, North VenganallurVillage, Krishnapuram Panchayat, Rajapalayam,Virudhunagar-626117.",CE,CIVIL  ENGINEERING,35,36,1
4678,"RAMCO Institute of Technology, North VenganallurVillage, Krishnapuram Panchayat, Rajapalayam,Virudhunagar-626117.",CS,COMPUTER SCIENCE ANDENGINEERING,69,106,37
4678,"RAMCO Institute of Technology, North VenganallurVillage, Krishnapuram Panchayat, Rajapalayam,Virudhunagar-626117.",EC,ELECTRONICS ANDCOMMUNICATIONENGINEERING,71,70,-1
4678,"RAMCO Institute of Technology, North VenganallurVillage, Krishnapuram Panchayat, Rajapalayam,Virudhunagar-626117.",EE,ELECTRICAL AND ELECTRONICSENGINEERING,35,35,0
4678,"RAMCO Institute of Technology, North VenganallurVillage, Krishnapuram Panchayat, Rajapalayam,Virudhunagar-626117.",IT,INFORMATION TECHNOLOGY,34,37,3
4678,"RAMCO Institute of Technology, North VenganallurVillage, Krishnapuram Panchayat, Rajapalayam,Virudhunagar-626117.",ME,MECHANICAL ENGINEERING,36,35,-1
4680,"AAA College of Engineering and Technology, AmathurVillage, Sivakasi, Virudhunagar-626123.",AD,Artificial Intelligence and DataScience,35,36,1
4680,"AAA College of Engineering and Technology, AmathurVillage, Sivakasi, Virudhunagar-626123.",CE,CIVIL  ENGINEERING,44,45,1
4680,"AAA College of Engineering and Technology, AmathurVillage, Sivakasi, Virudhunagar-626123.",CS,COMPUTER SCIENCE ANDENGINEERING,70,105,35
4680,"AAA College of Engineering and Technology, AmathurVillage, Sivakasi, Virudhunagar-626123.",EC,ELECTRONICS ANDCOMMUNICATIONENGINEERING,35,35,0
4680,"AAA College of Engineering and Technology, AmathurVillage, Sivakasi, Virudhunagar-626123.",EE,ELECTRICAL AND ELECTRONICSENGINEERING,45,45,0
4680,"AAA College of Engineering and Technology, AmathurVillage, Sivakasi, Virudhunagar-626123.",IT,INFORMATION TECHNOLOGY,35,36,1
4680,"AAA College of Engineering and Technology, AmathurVillage, Sivakasi, Virudhunagar-626123.",ME,MECHANICAL ENGINEERING,45,44,-1
4680,"AAA College of Engineering and Technology, AmathurVillage, Sivakasi, Virudhunagar-626123.",SC,Computer Science andEngineering (Cyber Security),35,35,0
4686,"Good Shepherd College of Engineering andTechnology, Maruthamparai, Kaliyal Village, Kaliyal,Kanyakumari-629151.",AD,Artificial Intelligence and DataScience,44,35,-9
4686,"Good Shepherd College of Engineering andTechnology, Maruthamparai, Kaliyal Village, Kaliyal,Kanyakumari-629151.",CE,CIVIL  ENGINEERING,35,18,-17
4686,"Good Shepherd College of Engineering andTechnology, Maruthamparai, Kaliyal Village, Kaliyal,Kanyakumari-629151.",CS,COMPUTER SCIENCE ANDENGINEERING,44,35,-9
4686,"Good Shepherd College of Engineering andTechnology, Maruthamparai, Kaliyal Village, Kaliyal,Kanyakumari-629151.",EC,ELECTRONICS ANDCOMMUNICATIONENGINEERING,40,36,-4
4686,"Good Shepherd College of Engineering andTechnology, Maruthamparai, Kaliyal Village, Kaliyal,Kanyakumari-629151.",IT,INFORMATION TECHNOLOGY,0,18,18
4686,"Good Shepherd College of Engineering andTechnology, Maruthamparai, Kaliyal Village, Kaliyal,Kanyakumari-629151.",ME,MECHANICAL ENGINEERING,41,35,-6
4864,"V V College of Engineering, V.V. Nagar, Arasur Village,Idaichivilai Post, Sathankulam Taluk, Tuticorin District,Tirunelveli-628656.",AD,Artificial Intelligence and DataScience,0,54,54
4864,"V V College of Engineering, V.V. Nagar, Arasur Village,Idaichivilai Post, Sathankulam Taluk, Tuticorin District,Tirunelveli-628656.",CE,CIVIL  ENGINEERING,27,28,1
4864,"V V College of Engineering, V.V. Nagar, Arasur Village,Idaichivilai Post, Sathankulam Taluk, Tuticorin District,Tirunelveli-628656.",CS,COMPUTER SCIENCE ANDENGINEERING,72,73,1
4864,"V V College of Engineering, V.V. Nagar, Arasur Village,Idaichivilai Post, Sathankulam Taluk, Tuticorin District,Tirunelveli-628656.",EC,ELECTRONICS ANDCOMMUNICATIONENGINEERING,55,54,-1
4864,"V V College of Engineering, V.V. Nagar, Arasur Village,Idaichivilai Post, Sathankulam Taluk, Tuticorin District,Tirunelveli-628656.",EE,ELECTRICAL AND ELECTRONICSENGINEERING,54,54,0
4864,"V V College of Engineering, V.V. Nagar, Arasur Village,Idaichivilai Post, Sathankulam Taluk, Tuticorin District,Tirunelveli-628656.",ME,MECHANICAL ENGINEERING,54,28,-26
4917,"Sethu Institute of Technology (Autonomous), Pulloor,Kariapatti, Virudhunagar-626115.",AD,Artificial Intelligence and DataScience,36,37,1
4917,"Sethu Institute of Technology (Autonomous), Pulloor,Kariapatti, Virudhunagar-626115.",AG,AGRICULTURE ENGINEERING,48,53,5
4917,"Sethu Institute of Technology (Autonomous), Pulloor,Kariapatti, Virudhunagar-626115.",AM,COMPUTER SCIENCE ANDENGINEERING (AI ANDMACHINE LEARNING),35,35,0
4917,"Sethu Institute of Technology (Autonomous), Pulloor,Kariapatti, Virudhunagar-626115.",BM,BIO MEDICAL ENGINEERING,44,54,10
4917,"Sethu Institute of Technology (Autonomous), Pulloor,Kariapatti, Virudhunagar-626115.",BT,BIO TECHNOLOGY,44,53,9
4917,"Sethu Institute of Technology (Autonomous), Pulloor,Kariapatti, Virudhunagar-626115.",CB,COMPUTER SCIENCE ANDBUSSINESS SYSTEM,36,36,0
4917,"Sethu Institute of Technology (Autonomous), Pulloor,Kariapatti, Virudhunagar-626115.",CD,COMPUTER SCIENCE ANDDESIGN,35,35,0
4917,"Sethu Institute of Technology (Autonomous), Pulloor,Kariapatti, Virudhunagar-626115.",CE,CIVIL  ENGINEERING,18,17,-1
4917,"Sethu Institute of Technology (Autonomous), Pulloor,Kariapatti, Virudhunagar-626115.",CH,CHEMICAL  ENGINEERING,27,23,-4
4917,"Sethu Institute of Technology (Autonomous), Pulloor,Kariapatti, Virudhunagar-626115.",CI,Computer Science andEngineering (Internet of Things),36,36,0
4917,"Sethu Institute of Technology (Autonomous), Pulloor,Kariapatti, Virudhunagar-626115.",CS,COMPUTER SCIENCE ANDENGINEERING,106,106,0
4917,"Sethu Institute of Technology (Autonomous), Pulloor,Kariapatti, Virudhunagar-626115.",EC,ELECTRONICS ANDCOMMUNICATIONENGINEERING,105,106,1
4917,"Sethu Institute of Technology (Autonomous), Pulloor,Kariapatti, Virudhunagar-626115.",EE,ELECTRICAL AND ELECTRONICSENGINEERING,35,35,0
4917,"Sethu Institute of Technology (Autonomous), Pulloor,Kariapatti, Virudhunagar-626115.",IT,INFORMATION TECHNOLOGY,71,70,-1
4917,"Sethu Institute of Technology (Autonomous), Pulloor,Kariapatti, Virudhunagar-626115.",ME,MECHANICAL ENGINEERING,35,35,0
4917,"Sethu Institute of Technology (Autonomous), Pulloor,Kariapatti, Virudhunagar-626115.",SC,Computer Science andEngineering (Cyber Security),35,35,0
4925,"Sun College of Engineering and Technology, UdayaNagar, Ammandivilai & Post, Kadiyapattanam,Kanyakumari-629204.",AD,Artificial Intelligence and DataScience,36,41,5
4925,"Sun College of Engineering and Technology, UdayaNagar, Ammandivilai & Post, Kadiyapattanam,Kanyakumari-629204.",AU,AUTOMOBILE ENGINEERING,0,54,54
4925,"Sun College of Engineering and Technology, UdayaNagar, Ammandivilai & Post, Kadiyapattanam,Kanyakumari-629204.",CH,CHEMICAL  ENGINEERING,0,55,55
4925,"Sun College of Engineering and Technology, UdayaNagar, Ammandivilai & Post, Kadiyapattanam,Kanyakumari-629204.",CS,COMPUTER SCIENCE ANDENGINEERING,0,108,108
4925,"Sun College of Engineering and Technology, UdayaNagar, Ammandivilai & Post, Kadiyapattanam,Kanyakumari-629204.",FD,FOOD TECHNOLOGY,35,54,19
4925,"Sun College of Engineering and Technology, UdayaNagar, Ammandivilai & Post, Kadiyapattanam,Kanyakumari-629204.",IT,INFORMATION TECHNOLOGY,0,55,55
4925,"Sun College of Engineering and Technology, UdayaNagar, Ammandivilai & Post, Kadiyapattanam,Kanyakumari-629204.",MD,MEDICAL ELECTRONICSENGINEERING,71,108,37
4925,"Sun College of Engineering and Technology, UdayaNagar, Ammandivilai & Post, Kadiyapattanam,Kanyakumari-629204.",PC,PETRO CHEMICALTECHNOLOGY,35,55,20
4925,"Sun College of Engineering and Technology, UdayaNagar, Ammandivilai & Post, Kadiyapattanam,Kanyakumari-629204.",PH,PHARMACEUTICALTECHNOLOGY,35,55,20
4927,"Maria College of Engineering and Technology, AttoorPuliyamoodu Junction, Thiruvattar P.O, Attoor,Kanyakumari-629177.",AU,AUTOMOBILE ENGINEERING,13,14,1
4927,Maria College of Engineering and Technology  AttoorPuliyamoodu Junction  Thiruvattar Post  KanyakumariDistrict 629177,BM,BIO MEDICAL ENGINEERING,14,0,-14
4927,"Maria College of Engineering and Technology, AttoorPuliyamoodu Junction, Thiruvattar P.O, Attoor,Kanyakumari-629177.",CE,CIVIL  ENGINEERING,27,27,0
4927,"Maria College of Engineering and Technology, AttoorPuliyamoodu Junction, Thiruvattar P.O, Attoor,Kanyakumari-629177.",CS,COMPUTER SCIENCE ANDENGINEERING,27,27,0
4927,"Maria College of Engineering and Technology, AttoorPuliyamoodu Junction, Thiruvattar P.O, Attoor,Kanyakumari-629177.",EC,ELECTRONICS ANDCOMMUNICATIONENGINEERING,17,14,-3
4927,"Maria College of Engineering and Technology, AttoorPuliyamoodu Junction, Thiruvattar P.O, Attoor,Kanyakumari-629177.",EE,ELECTRICAL AND ELECTRONICSENGINEERING,14,14,0
4927,"Maria College of Engineering and Technology, AttoorPuliyamoodu Junction, Thiruvattar P.O, Attoor,Kanyakumari-629177.",ME,MECHANICAL ENGINEERING,55,54,-1
4928,"Mar Ephraem College of Engineering and Technology,Malankara Hills, Elavuvillai, Kanyakumari-629171.",AD,Artificial Intelligence and DataScience,35,109,74
4928,"Mar Ephraem College of Engineering and Technology,Malankara Hills, Elavuvillai, Kanyakumari-629171.",CE,CIVIL  ENGINEERING,54,55,1
4928,"Mar Ephraem College of Engineering and Technology,Malankara Hills, Elavuvillai, Kanyakumari-629171.",CS,COMPUTER SCIENCE ANDENGINEERING,55,163,108
4928,"Mar Ephraem College of Engineering and Technology,Malankara Hills, Elavuvillai, Kanyakumari-629171.",EC,ELECTRONICS ANDCOMMUNICATIONENGINEERING,55,55,0
4928,"Mar Ephraem College of Engineering and Technology,Malankara Hills, Elavuvillai, Kanyakumari-629171.",EE,ELECTRICAL AND ELECTRONICSENGINEERING,55,54,-1
4928,"Mar Ephraem College of Engineering and Technology,Malankara Hills, Elavuvillai, Kanyakumari-629171.",ME,MECHANICAL ENGINEERING,108,53,-55
4929,"M.E.T. Engineering College, No.13/142A9/9,MogalsGarden, Chenbagaramanputhur, Thovalai Taluk,Kanyakumari district, Nagercoil-629304.",AD,Artificial Intelligence and DataScience,23,22,-1
4929,"M.E.T. Engineering College, No.13/142A9/9,MogalsGarden, Chenbagaramanputhur, Thovalai Taluk,Kanyakumari district, Nagercoil-629304.",CE,CIVIL  ENGINEERING,45,43,-2
4929,"M.E.T. Engineering College, No.13/142A9/9,MogalsGarden, Chenbagaramanputhur, Thovalai Taluk,Kanyakumari district, Nagercoil-629304.",CS,COMPUTER SCIENCE ANDENGINEERING,81,66,-15
4929,"M.E.T. Engineering College, No.13/142A9/9,MogalsGarden, Chenbagaramanputhur, Thovalai Taluk,Kanyakumari district, Nagercoil-629304.",EC,ELECTRONICS ANDCOMMUNICATIONENGINEERING,50,44,-6
4929,"M.E.T. Engineering College, No.13/142A9/9,MogalsGarden, Chenbagaramanputhur, Thovalai Taluk,Kanyakumari district, Nagercoil-629304.",EE,ELECTRICAL AND ELECTRONICSENGINEERING,44,44,0
4929,"M.E.T. Engineering College, No.13/142A9/9,MogalsGarden, Chenbagaramanputhur, Thovalai Taluk,Kanyakumari district, Nagercoil-629304.",ME,MECHANICAL ENGINEERING,45,43,-2
4931,"Grace College of Engineering , Chandy Nagar,Mullakkadu, Thoothukudi -628005.",AD,Artificial Intelligence and DataScience,18,41,23
4931,"Grace College of Engineering , Chandy Nagar,Mullakkadu, Thoothukudi -628005.",CE,CIVIL  ENGINEERING,18,24,6
4931,"Grace College of Engineering , Chandy Nagar,Mullakkadu, Thoothukudi -628005.",CS,COMPUTER SCIENCE ANDENGINEERING,100,41,-59
4931,"Grace College of Engineering , Chandy Nagar,Mullakkadu, Thoothukudi -628005.",EC,ELECTRONICS ANDCOMMUNICATIONENGINEERING,23,24,1
4931,"Grace College of Engineering , Chandy Nagar,Mullakkadu, Thoothukudi -628005.",EE,ELECTRICAL AND ELECTRONICSENGINEERING,22,24,2
4931,"Grace College of Engineering , Chandy Nagar,Mullakkadu, Thoothukudi -628005.",ME,MECHANICAL ENGINEERING,18,24,6
4932,"Immanuel Arasar JJ College of Engineering,Edavilagam, Nattalam, Marthandam, Kanyakumari-629195.",AD,Artificial Intelligence and DataScience,13,14,1
4932,"Immanuel Arasar JJ College of Engineering,Edavilagam, Nattalam, Marthandam, Kanyakumari-629195.",AE,AERONAUTICAL ENGINEERING,14,22,8
4932,"Immanuel Arasar JJ College of Engineering,Edavilagam, Nattalam, Marthandam, Kanyakumari-629195.",AG,AGRICULTURE ENGINEERING,0,41,41
4932,"Immanuel Arasar JJ College of Engineering,Edavilagam, Nattalam, Marthandam, Kanyakumari-629195.",BM,BIO MEDICAL ENGINEERING,0,41,41
4932,"Immanuel Arasar JJ College of Engineering,Edavilagam, Nattalam, Marthandam, Kanyakumari-629195.",CE,CIVIL  ENGINEERING,21,34,13
4932,"Immanuel Arasar JJ College of Engineering,Edavilagam, Nattalam, Marthandam, Kanyakumari-629195.",CS,COMPUTER SCIENCE ANDENGINEERING,22,21,-1
4932,"Immanuel Arasar JJ College of Engineering,Edavilagam, Nattalam, Marthandam, Kanyakumari-629195.",EC,ELECTRONICS ANDCOMMUNICATIONENGINEERING,14,21,7
4932,"Immanuel Arasar JJ College of Engineering,Edavilagam, Nattalam, Marthandam, Kanyakumari-629195.",EE,ELECTRICAL AND ELECTRONICSENGINEERING,13,21,8
4932,"Immanuel Arasar JJ College of Engineering,Edavilagam, Nattalam, Marthandam, Kanyakumari-629195.",IT,INFORMATION TECHNOLOGY,14,22,8
4932,"Immanuel Arasar JJ College of Engineering,Edavilagam, Nattalam, Marthandam, Kanyakumari-629195.",ME,MECHANICAL ENGINEERING,27,44,17
4932,"Immanuel Arasar JJ College of Engineering,Edavilagam, Nattalam, Marthandam, Kanyakumari-629195.",RM,ROBOTICS AND AUTOMATION,14,22,8
4933,"St. Mother Theresa Engineering College, Vagaikulam,Mudivaithanendal Post, Tuticorin District-628102.",AD,Artificial Intelligence and DataScience,0,41,41
4933,"St. Mother Theresa Engineering College, Vagaikulam,Mudivaithanendal Post, Tuticorin District-628102.",CS,COMPUTER SCIENCE ANDENGINEERING,145,113,-32
4933,"St. Mother Theresa Engineering College, Vagaikulam,Mudivaithanendal Post, Tuticorin District-628102.",EC,ELECTRONICS ANDCOMMUNICATIONENGINEERING,55,41,-14
4933,"St. Mother Theresa Engineering College, Vagaikulam,Mudivaithanendal Post, Tuticorin District-628102.",EE,ELECTRICAL AND ELECTRONICSENGINEERING,45,28,-17
4933,"St. Mother Theresa Engineering College, Vagaikulam,Mudivaithanendal Post, Tuticorin District-628102.",ME,MECHANICAL ENGINEERING,45,26,-19
4934,"Holy Cross Engineering College, 7/131, VagaikulamSrivaikuntam Express Road, Sri Mulakarai,Thannoothu Village, Srivaikuntam Taluk, Thoothukudi628851.",AD,Artificial Intelligence and DataScience,0,20,20
4934,"Holy Cross Engineering College, 7/131, VagaikulamSrivaikuntam Express Road, Sri Mulakarai,Thannoothu Village, Srivaikuntam Taluk, Thoothukudi628851.",BM,BIO MEDICAL ENGINEERING,40,51,11
4934,"Holy Cross Engineering College, 7/131, VagaikulamSrivaikuntam Express Road, Sri Mulakarai,Thannoothu Village, Srivaikuntam Taluk, Thoothukudi628851.",CS,COMPUTER SCIENCE ANDENGINEERING,45,44,-1
4934,"Holy Cross Engineering College, 7/131, VagaikulamSrivaikuntam Express Road, Sri Mulakarai,Thannoothu Village, Srivaikuntam Taluk, Thoothukudi628851.",EC,ELECTRONICS ANDCOMMUNICATIONENGINEERING,43,50,7
4934,"Holy Cross Engineering College, 7/131, VagaikulamSrivaikuntam Express Road, Sri Mulakarai,Thannoothu Village, Srivaikuntam Taluk, Thoothukudi628851.",EE,ELECTRICAL AND ELECTRONICSENGINEERING,44,27,-17
4934,"Holy Cross Engineering College, 7/131, VagaikulamSrivaikuntam Express Road, Sri Mulakarai,Thannoothu Village, Srivaikuntam Taluk, Thoothukudi628851.",IT,INFORMATION TECHNOLOGY,0,27,27
4934,"Holy Cross Engineering College, 7/131, VagaikulamSrivaikuntam Express Road, Sri Mulakarai,Thannoothu Village, Srivaikuntam Taluk, Thoothukudi628851.",ME,MECHANICAL ENGINEERING,44,28,-16
4937,"A.R College of Engineering and Technology, KadayamAlangulam Road, Near Railway Station, Kadayam,Therkkumadathur, Tirunelveli-627423.",CE,CIVIL  ENGINEERING,18,18,0
4937,"A.R College of Engineering and Technology, KadayamAlangulam Road, Near Railway Station, Kadayam,Therkkumadathur, Tirunelveli-627423.",CS,COMPUTER SCIENCE ANDENGINEERING,35,17,-18
4937,"A.R College of Engineering and Technology, KadayamAlangulam Road, Near Railway Station, Kadayam,Therkkumadathur, Tirunelveli-627423.",EC,ELECTRONICS ANDCOMMUNICATIONENGINEERING,17,18,1
4937,"A.R College of Engineering and Technology, KadayamAlangulam Road, Near Railway Station, Kadayam,Therkkumadathur, Tirunelveli-627423.",EE,ELECTRICAL AND ELECTRONICSENGINEERING,17,17,0
4937,"A.R College of Engineering and Technology, KadayamAlangulam Road, Near Railway Station, Kadayam,Therkkumadathur, Tirunelveli-627423.",ME,MECHANICAL ENGINEERING,18,18,0
4937,A.R College of Engineering and Technology  A.R NagarKadayam-Alangulam Road  Therkkumadathoor P.oAmbasamudram Taluk Tirunelveli-627423,MZ,Mechatronics Engineering,17,0,-17
4938,"Sivaji College of Engineering and Technology,Manivilai Post, Kanyakumari -629171.",AD,Artificial Intelligence and DataScience,35,35,0
4938,"Sivaji College of Engineering and Technology,Manivilai Post, Kanyakumari -629171.",AG,AGRICULTURE ENGINEERING,35,35,0
4938,"Sivaji College of Engineering and Technology,Manivilai Post, Kanyakumari -629171.",CE,CIVIL  ENGINEERING,35,35,0
4938,"Sivaji College of Engineering and Technology,Manivilai Post, Kanyakumari -629171.",CS,COMPUTER SCIENCE ANDENGINEERING,35,36,1
4938,"Sivaji College of Engineering and Technology,Manivilai Post, Kanyakumari -629171.",EE,ELECTRICAL AND ELECTRONICSENGINEERING,18,17,-1
4938,"Sivaji College of Engineering and Technology,Manivilai Post, Kanyakumari -629171.",ME,MECHANICAL ENGINEERING,19,19,0
4941,"Unnamalai Institute of Technology, Suba Nagar,Ayyaneri Post, Kovilpatti, Thoothukudi District-628502.",AD,Artificial Intelligence and DataScience,0,54,54
4941,"Unnamalai Institute of Technology, Suba Nagar,Ayyaneri Post, Kovilpatti, Thoothukudi District-628502.",CS,COMPUTER SCIENCE ANDENGINEERING,52,52,0
4941,"Unnamalai Institute of Technology, Suba Nagar,Ayyaneri Post, Kovilpatti, Thoothukudi District-628502.",EC,ELECTRONICS ANDCOMMUNICATIONENGINEERING,54,54,0
4941,"Unnamalai Institute of Technology, Suba Nagar,Ayyaneri Post, Kovilpatti, Thoothukudi District-628502.",EE,ELECTRICAL AND ELECTRONICSENGINEERING,54,54,0
4941,Unnamalai Institute of Technology  Ayyaneri  KovilpattiThoothukudi District 628502,ME,MECHANICAL ENGINEERING,55,0,-55
4941,"Unnamalai Institute of Technology, Suba Nagar,Ayyaneri Post, Kovilpatti, Thoothukudi District-628502.",SC,Computer Science andEngineering (Cyber Security),0,55,55
4943,"Satyam College of Engineering and Technology,Satyam Nagar, Kannappannalur, Aralvoimozhi,Kanyakumari District-629301.",AE,AERONAUTICAL ENGINEERING,30,36,6
4943,"Satyam College of Engineering and Technology,Satyam Nagar, Kannappannalur, Aralvoimozhi,Kanyakumari District-629301.",CE,CIVIL  ENGINEERING,64,63,-1
4943,"Satyam College of Engineering and Technology,Satyam Nagar, Kannappannalur, Aralvoimozhi,Kanyakumari District-629301.",CS,COMPUTER SCIENCE ANDENGINEERING,31,50,19
4943,"Satyam College of Engineering and Technology,Satyam Nagar, Kannappannalur, Aralvoimozhi,Kanyakumari District-629301.",EC,ELECTRONICS ANDCOMMUNICATIONENGINEERING,32,41,9
4943,"Satyam College of Engineering and Technology,Satyam Nagar, Kannappannalur, Aralvoimozhi,Kanyakumari District-629301.",EE,ELECTRICAL AND ELECTRONICSENGINEERING,32,34,2
4943,"Satyam College of Engineering and Technology,Satyam Nagar, Kannappannalur, Aralvoimozhi,Kanyakumari District-629301.",ME,MECHANICAL ENGINEERING,65,63,-2
4944,"Arunachala College of Engineering for Women,Thanka Gardens, Manavilai, Vellichanthai, Nagercoil,Kanyakumari District-629203.",AD,Artificial Intelligence and DataScience,108,164,56
4944,"Arunachala College of Engineering for Women,Thanka Gardens, Manavilai, Vellichanthai, Nagercoil,Kanyakumari District-629203.",CE,CIVIL  ENGINEERING,27,54,27
4944,"Arunachala College of Engineering for Women,Thanka Gardens, Manavilai, Vellichanthai, Nagercoil,Kanyakumari District-629203.",CS,COMPUTER SCIENCE ANDENGINEERING,97,164,67
4944,"Arunachala College of Engineering for Women,Thanka Gardens, Manavilai, Vellichanthai, Nagercoil,Kanyakumari District-629203.",EC,ELECTRONICS ANDCOMMUNICATIONENGINEERING,109,109,0
4944,"Arunachala College of Engineering for Women,Thanka Gardens, Manavilai, Vellichanthai, Nagercoil,Kanyakumari District-629203.",EE,ELECTRICAL AND ELECTRONICSENGINEERING,27,53,26
4944,"Arunachala College of Engineering for Women,Thanka Gardens, Manavilai, Vellichanthai, Nagercoil,Kanyakumari District-629203.",IT,INFORMATION TECHNOLOGY,55,109,54
4946,"DMI Engineering College, Kumarapuram Road,Aralvaimozhi, Kanyakumari District-629301.",AD,Artificial Intelligence and DataScience,44,72,28
4946,D M I Engineering College  Aralvaimozhi Village  ThovalaiKanyakumari District 629301,CE,CIVIL  ENGINEERING,14,0,-14
4946,"DMI Engineering College, Kumarapuram Road,Aralvaimozhi, Kanyakumari District-629301.",CS,COMPUTER SCIENCE ANDENGINEERING,72,100,28
4946,"DMI Engineering College, Kumarapuram Road,Aralvaimozhi, Kanyakumari District-629301.",EC,ELECTRONICS ANDCOMMUNICATIONENGINEERING,36,55,19
4946,"DMI Engineering College, Kumarapuram Road,Aralvaimozhi, Kanyakumari District-629301.",EE,ELECTRICAL AND ELECTRONICSENGINEERING,14,26,12
4946,"DMI Engineering College, Kumarapuram Road,Aralvaimozhi, Kanyakumari District-629301.",IT,INFORMATION TECHNOLOGY,41,55,14
4946,"DMI Engineering College, Kumarapuram Road,Aralvaimozhi, Kanyakumari District-629301.",ME,MECHANICAL ENGINEERING,23,55,32
4948,Rajas Institute of Technology   Ozhuginasery  NagercoilKanyakumari District 629001,CD,COMPUTER SCIENCE ANDDESIGN,48,0,-48
4948,Rajas Institute of Technology   Ozhuginasery  NagercoilKanyakumari District 629001,CE,CIVIL  ENGINEERING,49,0,-49
4948,Rajas Institute of Technology   Ozhuginasery  NagercoilKanyakumari District 629001,CS,COMPUTER SCIENCE ANDENGINEERING,48,0,-48
4948,Rajas Institute of Technology   Ozhuginasery  NagercoilKanyakumari District 629001,EC,ELECTRONICS ANDCOMMUNICATIONENGINEERING,49,0,-49
4948,Rajas Institute of Technology   Ozhuginasery  NagercoilKanyakumari District 629001,EE,ELECTRICAL ANDELECTRONICS ENGINEERING,24,0,-24
4948,Rajas Institute of Technology   Ozhuginasery  NagercoilKanyakumari District 629001,FT,FASHION TECHNOLOGY,49,0,-49
4949,"PSN Institute of Technology and Science,Melathediyoor, Palayamkottai Taluk, Tirunelveli-627152.",AD,Artificial Intelligence and DataScience,0,55,55
4949,"PSN Institute of Technology and Science,Melathediyoor, Palayamkottai Taluk, Tirunelveli-627152.",CE,CIVIL  ENGINEERING,54,27,-27
4949,"PSN Institute of Technology and Science,Melathediyoor, Palayamkottai Taluk, Tirunelveli-627152.",CS,COMPUTER SCIENCE ANDENGINEERING,44,54,10
4949,"PSN Institute of Technology and Science,Melathediyoor, Palayamkottai Taluk, Tirunelveli-627152.",EC,ELECTRONICS ANDCOMMUNICATIONENGINEERING,54,55,1
4949,"PSN Institute of Technology and Science,Melathediyoor, Palayamkottai Taluk, Tirunelveli-627152.",EE,ELECTRICAL AND ELECTRONICSENGINEERING,55,55,0
4949,"PSN Institute of Technology and Science,Melathediyoor, Palayamkottai Taluk, Tirunelveli-627152.",IN,INDUSTRIAL ENGINEERING ANDMANAGEMENT,27,27,0
4949,"PSN Institute of Technology and Science,Melathediyoor, Palayamkottai Taluk, Tirunelveli-627152.",IT,INFORMATION TECHNOLOGY,0,26,26
4949,"PSN Institute of Technology and Science,Melathediyoor, Palayamkottai Taluk, Tirunelveli-627152.",ME,MECHANICAL ENGINEERING,55,54,-1
4949,PSN Institute of Technology and Science MelathediyoorTirunelveli-627 152,MU,MECHANICAL ANDAUTOMATION ENGINEERING,54,0,-54
4949,"PSN Institute of Technology and Science,Melathediyoor, Palayamkottai Taluk, Tirunelveli-627152.",MZ,Mechatronics Engineering,55,55,0
4952,"C.S.I. Institute of Technology, Thovalai & PO,Kanyakumari District, Nagercoil-629302.",AD,Artificial Intelligence and DataScience,55,54,-1
4952,"C.S.I. Institute of Technology, Thovalai & PO,Kanyakumari District, Nagercoil-629302.",AM,COMPUTER SCIENCE ANDENGINEERING (AI ANDMACHINE LEARNING),0,55,55
4952,"C.S.I. Institute of Technology, Thovalai & PO,Kanyakumari District, Nagercoil-629302.",CE,CIVIL  ENGINEERING,27,27,0
4952,"C.S.I. Institute of Technology, Thovalai & PO,Kanyakumari District, Nagercoil-629302.",CS,COMPUTER SCIENCE ANDENGINEERING,108,108,0
4952,"C.S.I. Institute of Technology, Thovalai & PO,Kanyakumari District, Nagercoil-629302.",EC,ELECTRONICS ANDCOMMUNICATIONENGINEERING,55,55,0
4952,"C.S.I. Institute of Technology, Thovalai & PO,Kanyakumari District, Nagercoil-629302.",EE,ELECTRICAL AND ELECTRONICSENGINEERING,54,54,0
4952,"C.S.I. Institute of Technology, Thovalai & PO,Kanyakumari District, Nagercoil-629302.",IT,INFORMATION TECHNOLOGY,54,55,1
4952,"C.S.I. Institute of Technology, Thovalai & PO,Kanyakumari District, Nagercoil-629302.",ME,MECHANICAL ENGINEERING,54,54,0
4953,"Cape Institute of Technology, Rajakrishnapuram Post,Radhapuram Taluk, Levengipuram, Tirunelvei-627114.",AM,COMPUTER SCIENCE ANDENGINEERING (AI ANDMACHINE LEARNING),18,27,9
4953,"Cape Institute of Technology, Rajakrishnapuram Post,Radhapuram Taluk, Levengipuram, Tirunelvei-627114.",CE,CIVIL  ENGINEERING,18,28,10
4953,"Cape Institute of Technology, Rajakrishnapuram Post,Radhapuram Taluk, Levengipuram, Tirunelvei-627114.",CS,COMPUTER SCIENCE ANDENGINEERING,70,108,38
4953,"Cape Institute of Technology, Rajakrishnapuram Post,Radhapuram Taluk, Levengipuram, Tirunelvei-627114.",EC,ELECTRONICS ANDCOMMUNICATIONENGINEERING,35,55,20
4953,"Cape Institute of Technology, Rajakrishnapuram Post,Radhapuram Taluk, Levengipuram, Tirunelvei-627114.",EE,ELECTRICAL AND ELECTRONICSENGINEERING,35,55,20
4953,"Cape Institute of Technology, Rajakrishnapuram Post,Radhapuram Taluk, Levengipuram, Tirunelvei-627114.",IT,INFORMATION TECHNOLOGY,18,54,36
4953,"Cape Institute of Technology, Rajakrishnapuram Post,Radhapuram Taluk, Levengipuram, Tirunelvei-627114.",ME,MECHANICAL ENGINEERING,71,81,10
4954,"Dr Sivanthi aditanar College of Engineering,Tirunelveli Road, Tiruchendur, Thoothukudi-628215.",AD,Artificial Intelligence and DataScience,18,17,-1
4954,"Dr Sivanthi aditanar College of Engineering,Tirunelveli Road, Tiruchendur, Thoothukudi-628215.",CE,CIVIL  ENGINEERING,27,25,-2
4954,"Dr Sivanthi aditanar College of Engineering,Tirunelveli Road, Tiruchendur, Thoothukudi-628215.",CS,COMPUTER SCIENCE ANDENGINEERING,34,51,17
4954,"Dr Sivanthi aditanar College of Engineering,Tirunelveli Road, Tiruchendur, Thoothukudi-628215.",EC,ELECTRONICS ANDCOMMUNICATIONENGINEERING,18,18,0
4954,"Dr Sivanthi aditanar College of Engineering,Tirunelveli Road, Tiruchendur, Thoothukudi-628215.",EE,ELECTRICAL AND ELECTRONICSENGINEERING,19,18,-1
4954,"Dr Sivanthi aditanar College of Engineering,Tirunelveli Road, Tiruchendur, Thoothukudi-628215.",IT,INFORMATION TECHNOLOGY,35,36,1
4954,"Dr Sivanthi aditanar College of Engineering,Tirunelveli Road, Tiruchendur, Thoothukudi-628215.",ME,MECHANICAL ENGINEERING,27,26,-1
4955,"Francis Xavier Engineering College (Autonomous),103 G2, By Pass Road, Vannarpettai, Tirunelveli-627003.",AD,Artificial Intelligence and DataScience,55,54,-1
4955,"Francis Xavier Engineering College (Autonomous),103 G2, By Pass Road, Vannarpettai, Tirunelveli-627003.",AM,COMPUTER SCIENCE ANDENGINEERING (AI ANDMACHINE LEARNING),0,41,41
4955,"Francis Xavier Engineering College (Autonomous),103 G2, By Pass Road, Vannarpettai, Tirunelveli-627003.",CB,COMPUTER SCIENCE ANDBUSSINESS SYSTEM,45,45,0
4955,"Francis Xavier Engineering College (Autonomous),103 G2, By Pass Road, Vannarpettai, Tirunelveli-627003.",CE,CIVIL  ENGINEERING,46,18,-28
4955,"Francis Xavier Engineering College (Autonomous),103 G2, By Pass Road, Vannarpettai, Tirunelveli-627003.",CS,COMPUTER SCIENCE ANDENGINEERING,81,109,28
4955,"Francis Xavier Engineering College (Autonomous),103 G2, By Pass Road, Vannarpettai, Tirunelveli-627003.",EC,ELECTRONICS ANDCOMMUNICATIONENGINEERING,72,55,-17
4955,"Francis Xavier Engineering College (Autonomous),103 G2, By Pass Road, Vannarpettai, Tirunelveli-627003.",EE,ELECTRICAL AND ELECTRONICSENGINEERING,45,41,-4
4955,"Francis Xavier Engineering College (Autonomous),103 G2, By Pass Road, Vannarpettai, Tirunelveli-627003.",IT,INFORMATION TECHNOLOGY,63,64,1
4955,"Francis Xavier Engineering College (Autonomous),103 G2, By Pass Road, Vannarpettai, Tirunelveli-627003.",ME,MECHANICAL ENGINEERING,45,40,-5
4956,"Jayamatha Engineering College, ThirurajapuramMuppandal, Aralvaimozhi, Kanyakumari-629301.",CE,CIVIL  ENGINEERING,27,27,0
4956,"Jayamatha Engineering College, ThirurajapuramMuppandal, Aralvaimozhi, Kanyakumari-629301.",CS,COMPUTER SCIENCE ANDENGINEERING,14,13,-1
4956,"Jayamatha Engineering College, ThirurajapuramMuppandal, Aralvaimozhi, Kanyakumari-629301.",EC,ELECTRONICS ANDCOMMUNICATIONENGINEERING,21,20,-1
4956,"Jayamatha Engineering College, ThirurajapuramMuppandal, Aralvaimozhi, Kanyakumari-629301.",EE,ELECTRICAL AND ELECTRONICSENGINEERING,15,16,1
4956,"Jayamatha Engineering College, ThirurajapuramMuppandal, Aralvaimozhi, Kanyakumari-629301.",IC,INSTRUMENTATION ANDCONTROL ENGINEERING,16,16,0
4956,"Jayamatha Engineering College, ThirurajapuramMuppandal, Aralvaimozhi, Kanyakumari-629301.",ME,MECHANICAL ENGINEERING,22,23,1
4957,"Jayaraj Annapackiam CSI College of Engineering,Margoschis Nagar, Nazareth, Thoothukudi District-628617.",AD,Artificial Intelligence and DataScience,43,45,2
4957,"Jayaraj Annapackiam CSI College of Engineering,Margoschis Nagar, Nazareth, Thoothukudi District-628617.",CS,COMPUTER SCIENCE ANDENGINEERING,38,96,58
4957,"Jayaraj Annapackiam CSI College of Engineering,Margoschis Nagar, Nazareth, Thoothukudi District-628617.",EC,ELECTRONICS ANDCOMMUNICATIONENGINEERING,54,55,1
4957,"Jayaraj Annapackiam CSI College of Engineering,Margoschis Nagar, Nazareth, Thoothukudi District-628617.",IT,INFORMATION TECHNOLOGY,52,54,2
4957,"Jayaraj Annapackiam CSI College of Engineering,Margoschis Nagar, Nazareth, Thoothukudi District-628617.",ME,MECHANICAL ENGINEERING,55,53,-2
4959,"Kamaraj College of Engineering and Technology(Autonomous), S.P.G.C.Nagar Post Box12,K.Vellakulam, Virudhunagar-626001.",AD,Artificial Intelligence and DataScience,34,71,37
4959,"Kamaraj College of Engineering and Technology(Autonomous), S.P.G.C.Nagar Post Box12,K.Vellakulam, Virudhunagar-626001.",BT,BIO TECHNOLOGY,41,36,-5
4959,"Kamaraj College of Engineering and Technology(Autonomous), S.P.G.C.Nagar Post Box12,K.Vellakulam, Virudhunagar-626001.",CE,CIVIL  ENGINEERING,18,18,0
4959,"Kamaraj College of Engineering and Technology(Autonomous), S.P.G.C.Nagar Post Box12,K.Vellakulam, Virudhunagar-626001.",CS,COMPUTER SCIENCE ANDENGINEERING,106,106,0
4959,"Kamaraj College of Engineering and Technology(Autonomous), S.P.G.C.Nagar Post Box12,K.Vellakulam, Virudhunagar-626001.",EC,ELECTRONICS ANDCOMMUNICATIONENGINEERING,69,72,3
4959,"Kamaraj College of Engineering and Technology(Autonomous), S.P.G.C.Nagar Post Box12,K.Vellakulam, Virudhunagar-626001.",EE,ELECTRICAL AND ELECTRONICSENGINEERING,18,17,-1
4959,"Kamaraj College of Engineering and Technology(Autonomous), S.P.G.C.Nagar Post Box12,K.Vellakulam, Virudhunagar-626001.",IT,INFORMATION TECHNOLOGY,70,70,0
4959,"Kamaraj College of Engineering and Technology(Autonomous), S.P.G.C.Nagar Post Box12,K.Vellakulam, Virudhunagar-626001.",ME,MECHANICAL ENGINEERING,18,17,-1
4959,"Kamaraj College of Engineering and Technology(Autonomous), S.P.G.C.Nagar Post Box12,K.Vellakulam, Virudhunagar-626001.",MZ,Mechatronics Engineering,18,18,0
4960,"Mepco Schlenk Engineering College (Autonomous),Sivakasi,Mepco Engineering CollegePost,Virudhunagar District-626005.",AD,Artificial Intelligence and DataScience,70,71,1
4960,"Mepco Schlenk Engineering College (Autonomous),Sivakasi,Mepco Engineering CollegePost,Virudhunagar District-626005.",BM,BIO MEDICAL ENGINEERING,35,36,1
4960,"Mepco Schlenk Engineering College (Autonomous),Sivakasi,Mepco Engineering CollegePost,Virudhunagar District-626005.",BT,BIO TECHNOLOGY,35,36,1
4960,"Mepco Schlenk Engineering College (Autonomous),Sivakasi,Mepco Engineering CollegePost,Virudhunagar District-626005.",CE,CIVIL  ENGINEERING,70,71,1
4960,"Mepco Schlenk Engineering College (Autonomous),Sivakasi,Mepco Engineering CollegePost,Virudhunagar District-626005.",CS,COMPUTER SCIENCE ANDENGINEERING,107,105,-2
4960,"Mepco Schlenk Engineering College (Autonomous),Sivakasi,Mepco Engineering CollegePost,Virudhunagar District-626005.",EC,ELECTRONICS ANDCOMMUNICATIONENGINEERING,106,105,-1
4960,"Mepco Schlenk Engineering College (Autonomous),Sivakasi,Mepco Engineering CollegePost,Virudhunagar District-626005.",EE,ELECTRICAL AND ELECTRONICSENGINEERING,70,71,1
4960,"Mepco Schlenk Engineering College (Autonomous),Sivakasi,Mepco Engineering CollegePost,Virudhunagar District-626005.",IT,INFORMATION TECHNOLOGY,68,71,3
4960,"Mepco Schlenk Engineering College (Autonomous),Sivakasi,Mepco Engineering CollegePost,Virudhunagar District-626005.",ME,MECHANICAL ENGINEERING,71,70,-1
4961,"Nellai College of Engineering , Maruthakulam P.O,Nanguneri Taluk, Tirunelveli-627151.",AD,Artificial Intelligence and DataScience,0,27,27
4961,"Nellai College of Engineering , Maruthakulam P.O,Nanguneri Taluk, Tirunelveli-627151.",CE,CIVIL  ENGINEERING,36,23,-13
4961,"Nellai College of Engineering , Maruthakulam P.O,Nanguneri Taluk, Tirunelveli-627151.",CS,COMPUTER SCIENCE ANDENGINEERING,81,81,0
4961,"Nellai College of Engineering , Maruthakulam P.O,Nanguneri Taluk, Tirunelveli-627151.",EC,ELECTRONICS ANDCOMMUNICATIONENGINEERING,54,50,-4
4961,"Nellai College of Engineering , Maruthakulam P.O,Nanguneri Taluk, Tirunelveli-627151.",EE,ELECTRICAL AND ELECTRONICSENGINEERING,55,45,-10
4961,"Nellai College of Engineering , Maruthakulam P.O,Nanguneri Taluk, Tirunelveli-627151.",ME,MECHANICAL ENGINEERING,36,27,-9
4961,"Nellai College of Engineering , Maruthakulam P.O,Nanguneri Taluk, Tirunelveli-627151.",SC,Computer Science andEngineering (Cyber Security),0,28,28
4962,"National Engineering College (Autonomous), K.R.Nagar, Nalattinputhur, Kovilpatti, Tuticorin District-628503.",AD,Artificial Intelligence and DataScience,36,36,0
4962,"National Engineering College (Autonomous), K.R.Nagar, Nalattinputhur, Kovilpatti, Tuticorin District-628503.",CE,CIVIL  ENGINEERING,35,36,1
4962,"National Engineering College (Autonomous), K.R.Nagar, Nalattinputhur, Kovilpatti, Tuticorin District-628503.",CS,COMPUTER SCIENCE ANDENGINEERING,69,70,1
4962,"National Engineering College (Autonomous), K.R.Nagar, Nalattinputhur, Kovilpatti, Tuticorin District-628503.",EC,ELECTRONICS ANDCOMMUNICATIONENGINEERING,70,70,0
4962,"National Engineering College (Autonomous), K.R.Nagar, Nalattinputhur, Kovilpatti, Tuticorin District-628503.",EE,ELECTRICAL AND ELECTRONICSENGINEERING,35,35,0
4962,"National Engineering College (Autonomous), K.R.Nagar, Nalattinputhur, Kovilpatti, Tuticorin District-628503.",IT,INFORMATION TECHNOLOGY,35,35,0
4962,"National Engineering College (Autonomous), K.R.Nagar, Nalattinputhur, Kovilpatti, Tuticorin District-628503.",ME,MECHANICAL ENGINEERING,36,36,0
4964,PSN College of Engineering and  Technology(Autonomous) Melathediyoor  Tirunelveli-627 152,AD,Artificial Intelligence and DataScience,0,44,44
4964,PSN College of Engineering and  Technology(Autonomous) Melathediyoor  Tirunelveli-627 152,AE,AERONAUTICAL ENGINEERING,52,54,2
4964,PSN College of Engineering and  Technology(Autonomous) Melathediyoor  Tirunelveli-627 152,AM,COMPUTER SCIENCE ANDENGINEERING (AI ANDMACHINE LEARNING),0,27,27
4964,PSN College of Engineering and  Technology(Autonomous) Melathediyoor  Tirunelveli-627 152,BM,BIO MEDICAL ENGINEERING,0,54,54
4964,PSN College of Engineering and  Technology(Autonomous) Melathediyoor  Tirunelveli-627 152,CE,CIVIL  ENGINEERING,35,54,19
4964,PSN College of Engineering and  Technology(Autonomous) Melathediyoor  Tirunelveli-627 152,CS,COMPUTER SCIENCE ANDENGINEERING,54,60,6
4964,PSN College of Engineering and  Technology(Autonomous) Melathediyoor  Tirunelveli-627 152,EC,ELECTRONICS ANDCOMMUNICATIONENGINEERING,53,82,29
4964,PSN College of Engineering and  Technology(Autonomous) Melathediyoor  Tirunelveli-627 152,EE,ELECTRICAL AND ELECTRONICSENGINEERING,55,54,-1
4964,PSN College of Engineering and  Technology(Autonomous) Melathediyoor  Tirunelveli-627 152,ME,MECHANICAL ENGINEERING,35,55,20
4964,PSN College of Engineering and  Technology(Autonomous) Melathediyoor  Tirunelveli-627 152,MR,MARINE ENGINEERING,36,55,19
4964,PSN College of Engineering and  Technology(Autonomous) Melathediyoor  Tirunelveli-627 152,MU,MECHANICAL ANDAUTOMATION ENGINEERING,55,54,-1
4965,"P.S.R. Engineering College (Autonomous),Appayanaickenpatty, Sevalpatty, Sivakasi,Virudhunagar District -626140.",AD,Artificial Intelligence and DataScience,27,27,0
4965,"P.S.R. Engineering College (Autonomous),Appayanaickenpatty, Sevalpatty, Sivakasi,Virudhunagar District -626140.",BM,BIO MEDICAL ENGINEERING,45,54,9
4965,"P.S.R. Engineering College (Autonomous),Appayanaickenpatty, Sevalpatty, Sivakasi,Virudhunagar District -626140.",BT,BIO TECHNOLOGY,22,26,4
4965,"P.S.R. Engineering College (Autonomous),Appayanaickenpatty, Sevalpatty, Sivakasi,Virudhunagar District -626140.",CE,CIVIL  ENGINEERING,27,28,1
4965,"P.S.R. Engineering College (Autonomous),Appayanaickenpatty, Sevalpatty, Sivakasi,Virudhunagar District -626140.",CS,COMPUTER SCIENCE ANDENGINEERING,53,81,28
4965,"P.S.R. Engineering College (Autonomous),Appayanaickenpatty, Sevalpatty, Sivakasi,Virudhunagar District -626140.",EC,ELECTRONICS ANDCOMMUNICATIONENGINEERING,64,68,4
4965,"P.S.R. Engineering College (Autonomous),Appayanaickenpatty, Sevalpatty, Sivakasi,Virudhunagar District -626140.",EE,ELECTRICAL AND ELECTRONICSENGINEERING,45,55,10
4965,"P.S.R. Engineering College (Autonomous),Appayanaickenpatty, Sevalpatty, Sivakasi,Virudhunagar District -626140.",IT,INFORMATION TECHNOLOGY,14,36,22
4965,"P.S.R. Engineering College (Autonomous),Appayanaickenpatty, Sevalpatty, Sivakasi,Virudhunagar District -626140.",ME,MECHANICAL ENGINEERING,54,55,1
4966,"PET Engineering College, Thiruchendur Road, Vallioor,Tirunelveli -627117.",AD,Artificial Intelligence and DataScience,22,45,23
4966,"PET Engineering College, Thiruchendur Road, Vallioor,Tirunelveli -627117.",CE,CIVIL  ENGINEERING,14,22,8
4966,"PET Engineering College, Thiruchendur Road, Vallioor,Tirunelveli -627117.",CS,COMPUTER SCIENCE ANDENGINEERING,68,68,0
4966,"PET Engineering College, Thiruchendur Road, Vallioor,Tirunelveli -627117.",EC,ELECTRONICS ANDCOMMUNICATIONENGINEERING,45,46,1
4966,"PET Engineering College, Thiruchendur Road, Vallioor,Tirunelveli -627117.",EE,ELECTRICAL AND ELECTRONICSENGINEERING,22,23,1
4966,"PET Engineering College, Thiruchendur Road, Vallioor,Tirunelveli -627117.",ME,MECHANICAL ENGINEERING,45,45,0
4967,"S. Veerasamy Chettiar College of Engineering andTechnology, S.V.Nagar, Puliangudi (Post), Sivagiri(Taluk), Tirunelveli District-627855.",AD,Artificial Intelligence and DataScience,35,35,0
4967,"S. Veerasamy Chettiar College of Engineering andTechnology, S.V.Nagar, Puliangudi (Post), Sivagiri(Taluk), Tirunelveli District-627855.",CE,CIVIL  ENGINEERING,18,17,-1
4967,"S. Veerasamy Chettiar College of Engineering andTechnology, S.V.Nagar, Puliangudi (Post), Sivagiri(Taluk), Tirunelveli District-627855.",CS,COMPUTER SCIENCE ANDENGINEERING,35,36,1
4967,"S. Veerasamy Chettiar College of Engineering andTechnology, S.V.Nagar, Puliangudi (Post), Sivagiri(Taluk), Tirunelveli District-627855.",EC,ELECTRONICS ANDCOMMUNICATIONENGINEERING,35,36,1
4967,"S. Veerasamy Chettiar College of Engineering andTechnology, S.V.Nagar, Puliangudi (Post), Sivagiri(Taluk), Tirunelveli District-627855.",EE,ELECTRICAL AND ELECTRONICSENGINEERING,19,17,-2
4967,"S. Veerasamy Chettiar College of Engineering andTechnology, S.V.Nagar, Puliangudi (Post), Sivagiri(Taluk), Tirunelveli District-627855.",IT,INFORMATION TECHNOLOGY,35,35,0
4967,"S. Veerasamy Chettiar College of Engineering andTechnology, S.V.Nagar, Puliangudi (Post), Sivagiri(Taluk), Tirunelveli District-627855.",ME,MECHANICAL ENGINEERING,17,18,1
4967,"S. Veerasamy Chettiar College of Engineering andTechnology, S.V.Nagar, Puliangudi (Post), Sivagiri(Taluk), Tirunelveli District-627855.",SC,Computer Science andEngineering (Cyber Security),18,18,0
4968,"Sardar Raja College of Engineering, Raja Nagar,Alangulam, Tirunelveli Distict-627808.",AD,Artificial Intelligence and DataScience,50,55,5
4968,"Sardar Raja College of Engineering, Raja Nagar,Alangulam, Tirunelveli Distict-627808.",CE,CIVIL  ENGINEERING,24,27,3
4968,"Sardar Raja College of Engineering, Raja Nagar,Alangulam, Tirunelveli Distict-627808.",CS,COMPUTER SCIENCE ANDENGINEERING,50,54,4
4968,"Sardar Raja College of Engineering, Raja Nagar,Alangulam, Tirunelveli Distict-627808.",EC,ELECTRONICS ANDCOMMUNICATIONENGINEERING,50,54,4
4968,"Sardar Raja College of Engineering, Raja Nagar,Alangulam, Tirunelveli Distict-627808.",EE,ELECTRICAL AND ELECTRONICSENGINEERING,25,28,3
4968,"Sardar Raja College of Engineering, Raja Nagar,Alangulam, Tirunelveli Distict-627808.",ME,MECHANICAL ENGINEERING,50,54,4
4969,"SCAD College of Engineering and Technology, ScadNagar, Cheranmahadevi, Tirunelveli-627414.",AD,Artificial Intelligence and DataScience,0,27,27
4969,"SCAD College of Engineering and Technology, ScadNagar, Cheranmahadevi, Tirunelveli-627414.",CE,CIVIL  ENGINEERING,22,14,-8
4969,"SCAD College of Engineering and Technology, ScadNagar, Cheranmahadevi, Tirunelveli-627414.",CS,COMPUTER SCIENCE ANDENGINEERING,136,109,-27
4969,"SCAD College of Engineering and Technology, ScadNagar, Cheranmahadevi, Tirunelveli-627414.",EC,ELECTRONICS ANDCOMMUNICATIONENGINEERING,49,45,-4
4969,"SCAD College of Engineering and Technology, ScadNagar, Cheranmahadevi, Tirunelveli-627414.",EE,ELECTRICAL AND ELECTRONICSENGINEERING,50,46,-4
4969,"SCAD College of Engineering and Technology, ScadNagar, Cheranmahadevi, Tirunelveli-627414.",ME,MECHANICAL ENGINEERING,50,45,-5
4970,"Sree Sowdambika College of Engineering,Chettikurichi, Aruppukottai, Virudhunagar-626134.",CE,CIVIL  ENGINEERING,27,23,-4
4970,"Sree Sowdambika College of Engineering,Chettikurichi, Aruppukottai, Virudhunagar-626134.",CS,COMPUTER SCIENCE ANDENGINEERING,100,99,-1
4970,"Sree Sowdambika College of Engineering,Chettikurichi, Aruppukottai, Virudhunagar-626134.",EC,ELECTRONICS ANDCOMMUNICATIONENGINEERING,53,50,-3
4970,"Sree Sowdambika College of Engineering,Chettikurichi, Aruppukottai, Virudhunagar-626134.",EE,ELECTRICAL AND ELECTRONICSENGINEERING,54,49,-5
4970,"Sree Sowdambika College of Engineering,Chettikurichi, Aruppukottai, Virudhunagar-626134.",ME,MECHANICAL ENGINEERING,27,25,-2
4971,"St. Xavier's Catholic College of Engineering(Autonomous), Chunkankadai, Kanyakumari District,Nagercoil-629003.",AD,Artificial Intelligence and DataScience,27,55,28
4971,"St. Xavier's Catholic College of Engineering(Autonomous), Chunkankadai, Kanyakumari District,Nagercoil-629003.",CE,CIVIL  ENGINEERING,36,36,0
4971,"St. Xavier's Catholic College of Engineering(Autonomous), Chunkankadai, Kanyakumari District,Nagercoil-629003.",CS,COMPUTER SCIENCE ANDENGINEERING,53,81,28
4971,"St. Xavier's Catholic College of Engineering(Autonomous), Chunkankadai, Kanyakumari District,Nagercoil-629003.",EC,ELECTRONICS ANDCOMMUNICATIONENGINEERING,55,54,-1
4971,"St. Xavier's Catholic College of Engineering(Autonomous), Chunkankadai, Kanyakumari District,Nagercoil-629003.",EE,ELECTRICAL AND ELECTRONICSENGINEERING,27,27,0
4971,"St. Xavier's Catholic College of Engineering(Autonomous), Chunkankadai, Kanyakumari District,Nagercoil-629003.",IT,INFORMATION TECHNOLOGY,27,27,0
4971,"St. Xavier's Catholic College of Engineering(Autonomous), Chunkankadai, Kanyakumari District,Nagercoil-629003.",ME,MECHANICAL ENGINEERING,64,59,-5
4972,AMRITA  College of Engineering and TechnologyErachakulam Post  Kanyakumari District 629902,AD,ARTIFICIAL INTELLIGENCEAND DATA SCIENCE,34,0,-34
4972,AMRITA  College of Engineering and TechnologyErachakulam Post  Kanyakumari District 629902,CE,CIVIL  ENGINEERING,18,0,-18
4972,AMRITA  College of Engineering and TechnologyErachakulam Post  Kanyakumari District 629902,CS,COMPUTER SCIENCE ANDENGINEERING,70,0,-70
4972,AMRITA  College of Engineering and TechnologyErachakulam Post  Kanyakumari District 629902,EC,ELECTRONICS ANDCOMMUNICATIONENGINEERING,71,0,-71
4972,AMRITA  College of Engineering and TechnologyErachakulam Post  Kanyakumari District 629902,EE,ELECTRICAL ANDELECTRONICS ENGINEERING,35,0,-35
4972,AMRITA  College of Engineering and TechnologyErachakulam Post  Kanyakumari District 629902,ME,MECHANICAL ENGINEERING,18,0,-18
4974,Government College of Engineering  TirunelveliDistrict 627007,CE,CIVIL  ENGINEERING,54,55,1
4974,Government College of Engineering  TirunelveliDistrict 627007,CS,COMPUTER SCIENCE ANDENGINEERING,51,54,3
4974,Government College of Engineering  TirunelveliDistrict 627007,EC,ELECTRONICS ANDCOMMUNICATIONENGINEERING,108,109,1
4974,Government College of Engineering  TirunelveliDistrict 627007,EE,ELECTRICAL AND ELECTRONICSENGINEERING,55,55,0
4974,Government College of Engineering  TirunelveliDistrict 627007,ME,MECHANICAL ENGINEERING,108,108,0
4975,"Dr G.U. Pope College of Engineering, Pope Nagar,Sawyerpuram, Thoothukudi-628251.",CE,CIVIL  ENGINEERING,27,26,-1
4975,"Dr G.U. Pope College of Engineering, Pope Nagar,Sawyerpuram, Thoothukudi-628251.",CS,COMPUTER SCIENCE ANDENGINEERING,54,83,29
4975,"Dr G.U. Pope College of Engineering, Pope Nagar,Sawyerpuram, Thoothukudi-628251.",EC,ELECTRONICS ANDCOMMUNICATIONENGINEERING,55,54,-1
4975,"Dr G.U. Pope College of Engineering, Pope Nagar,Sawyerpuram, Thoothukudi-628251.",EE,ELECTRICAL AND ELECTRONICSENGINEERING,36,36,0
4975,"Dr G.U. Pope College of Engineering, Pope Nagar,Sawyerpuram, Thoothukudi-628251.",ME,MECHANICAL ENGINEERING,54,54,0
4976,"Infant Jesus College of Engineering, Kamarajar Nagar,Tirunelveli-Thoothukudi Highway (NH-7A),Keelavallanadu Village, Ellanayakkan Patti Post,Srivaikundam Taluk, Thoothukudi District-628851.",AE,AERONAUTICAL ENGINEERING,28,55,27
4976,"Infant Jesus College of Engineering, Kamarajar Nagar,Tirunelveli-Thoothukudi Highway (NH-7A),Keelavallanadu Village, Ellanayakkan Patti Post,Srivaikundam Taluk, Thoothukudi District-628851.",AG,AGRICULTURE ENGINEERING,27,55,28
4976,"Infant Jesus College of Engineering, Kamarajar Nagar,Tirunelveli-Thoothukudi Highway (NH-7A),Keelavallanadu Village, Ellanayakkan Patti Post,Srivaikundam Taluk, Thoothukudi District-628851.",CS,COMPUTER SCIENCE ANDENGINEERING,41,55,14
4976,"Infant Jesus College of Engineering, Kamarajar Nagar,Tirunelveli-Thoothukudi Highway (NH-7A),Keelavallanadu Village, Ellanayakkan Patti Post,Srivaikundam Taluk, Thoothukudi District-628851.",EC,ELECTRONICS ANDCOMMUNICATIONENGINEERING,28,26,-2
4976,"Infant Jesus College of Engineering, Kamarajar Nagar,Tirunelveli-Thoothukudi Highway (NH-7A),Keelavallanadu Village, Ellanayakkan Patti Post,Srivaikundam Taluk, Thoothukudi District-628851.",ME,MECHANICAL ENGINEERING,26,54,28
4977,"Narayanaguru College of Engineering, Chittadavu,Manjalumoodu, Vilavancode Taluk, Kuzhithurai,Kanyakumari District-629151.",AD,Artificial Intelligence and DataScience,14,54,40
4977,Narayanaguru College of Engineering  ManjalumooduKanyakumari District 629151,AU,AUTOMOBILE ENGINEERING,24,0,-24
4977,"Narayanaguru College of Engineering, Chittadavu,Manjalumoodu, Vilavancode Taluk, Kuzhithurai,Kanyakumari District-629151.",CE,CIVIL  ENGINEERING,54,27,-27
4977,"Narayanaguru College of Engineering, Chittadavu,Manjalumoodu, Vilavancode Taluk, Kuzhithurai,Kanyakumari District-629151.",CS,COMPUTER SCIENCE ANDENGINEERING,109,109,0
4977,"Narayanaguru College of Engineering, Chittadavu,Manjalumoodu, Vilavancode Taluk, Kuzhithurai,Kanyakumari District-629151.",EC,ELECTRONICS ANDCOMMUNICATIONENGINEERING,55,55,0
4977,"Narayanaguru College of Engineering, Chittadavu,Manjalumoodu, Vilavancode Taluk, Kuzhithurai,Kanyakumari District-629151.",EE,ELECTRICAL AND ELECTRONICSENGINEERING,24,24,0
4977,"Narayanaguru College of Engineering, Chittadavu,Manjalumoodu, Vilavancode Taluk, Kuzhithurai,Kanyakumari District-629151.",IT,INFORMATION TECHNOLOGY,0,27,27
4977,"Narayanaguru College of Engineering, Chittadavu,Manjalumoodu, Vilavancode Taluk, Kuzhithurai,Kanyakumari District-629151.",ME,MECHANICAL ENGINEERING,55,55,0
4978,"Udaya School of Engineering, Udaya Nagar, VellamadiJunction,Ammandivilai Post, Kanyakumarai District,Nagercoil-629204.",AE,AERONAUTICAL ENGINEERING,27,28,1
4978,"Udaya School of Engineering, Udaya Nagar, VellamadiJunction,Ammandivilai Post, Kanyakumarai District,Nagercoil-629204.",AG,AGRICULTURE ENGINEERING,54,54,0
4978,"Udaya School of Engineering, Udaya Nagar, VellamadiJunction,Ammandivilai Post, Kanyakumarai District,Nagercoil-629204.",AM,COMPUTER SCIENCE ANDENGINEERING (AI ANDMACHINE LEARNING),55,53,-2
4978,"Udaya School of Engineering, Udaya Nagar, VellamadiJunction,Ammandivilai Post, Kanyakumarai District,Nagercoil-629204.",BM,BIO MEDICAL ENGINEERING,55,54,-1
4978,"Udaya School of Engineering, Udaya Nagar, VellamadiJunction,Ammandivilai Post, Kanyakumarai District,Nagercoil-629204.",BT,BIO TECHNOLOGY,54,54,0
4978,"Udaya School of Engineering, Udaya Nagar, VellamadiJunction,Ammandivilai Post, Kanyakumarai District,Nagercoil-629204.",CE,CIVIL  ENGINEERING,54,54,0
4978,"Udaya School of Engineering, Udaya Nagar, VellamadiJunction,Ammandivilai Post, Kanyakumarai District,Nagercoil-629204.",CS,COMPUTER SCIENCE ANDENGINEERING,55,55,0
4978,"Udaya School of Engineering, Udaya Nagar, VellamadiJunction,Ammandivilai Post, Kanyakumarai District,Nagercoil-629204.",EC,ELECTRONICS ANDCOMMUNICATIONENGINEERING,27,28,1
4978,"Udaya School of Engineering, Udaya Nagar, VellamadiJunction,Ammandivilai Post, Kanyakumarai District,Nagercoil-629204.",EE,ELECTRICAL AND ELECTRONICSENGINEERING,54,55,1
4978,"Udaya School of Engineering, Udaya Nagar, VellamadiJunction,Ammandivilai Post, Kanyakumarai District,Nagercoil-629204.",ME,MECHANICAL ENGINEERING,80,81,1
4978,"Udaya School of Engineering, Udaya Nagar, VellamadiJunction,Ammandivilai Post, Kanyakumarai District,Nagercoil-629204.",RM,ROBOTICS AND AUTOMATION,27,28,1
4978,"Udaya School of Engineering, Udaya Nagar, VellamadiJunction,Ammandivilai Post, Kanyakumarai District,Nagercoil-629204.",SC,Computer Science andEngineering (Cyber Security),55,54,-1
4979,"Arul Tharum VPMM College of Engineering andTechnology, V.P.M. Nagar, Krishnankovil, Srivilliputur,Virudhunagar-626190.",AD,Artificial Intelligence and DataScience,0,18,18
4979,"Arul Tharum VPMM College of Engineering andTechnology, V.P.M. Nagar, Krishnankovil, Srivilliputur,Virudhunagar-626190.",AM,COMPUTER SCIENCE ANDENGINEERING (AI ANDMACHINE LEARNING),0,18,18
4979,"Arul Tharum VPMM College of Engineering andTechnology, V.P.M. Nagar, Krishnankovil, Srivilliputur,Virudhunagar-626190.",CE,CIVIL  ENGINEERING,23,17,-6
4979,"Arul Tharum VPMM College of Engineering andTechnology, V.P.M. Nagar, Krishnankovil, Srivilliputur,Virudhunagar-626190.",CS,COMPUTER SCIENCE ANDENGINEERING,45,36,-9
4979,"Arul Tharum VPMM College of Engineering andTechnology, V.P.M. Nagar, Krishnankovil, Srivilliputur,Virudhunagar-626190.",EC,ELECTRONICS ANDCOMMUNICATIONENGINEERING,45,36,-9
4979,"Arul Tharum VPMM College of Engineering andTechnology, V.P.M. Nagar, Krishnankovil, Srivilliputur,Virudhunagar-626190.",EE,ELECTRICAL AND ELECTRONICSENGINEERING,46,35,-11
4979,"Arul Tharum VPMM College of Engineering andTechnology, V.P.M. Nagar, Krishnankovil, Srivilliputur,Virudhunagar-626190.",IT,INFORMATION TECHNOLOGY,45,35,-10
4979,"Arul Tharum VPMM College of Engineering andTechnology, V.P.M. Nagar, Krishnankovil, Srivilliputur,Virudhunagar-626190.",SC,Computer Science andEngineering (Cyber Security),0,17,17
4980,"Einstein College of Engineering, Sir.C.V.Raman Nagar,Seethaparpanallur, Tirunelveli-627012.",AD,Artificial Intelligence and DataScience,0,54,54
4980,"Einstein College of Engineering, Sir.C.V.Raman Nagar,Seethaparpanallur, Tirunelveli-627012.",CE,CIVIL  ENGINEERING,19,26,7
4980,"Einstein College of Engineering, Sir.C.V.Raman Nagar,Seethaparpanallur, Tirunelveli-627012.",CS,COMPUTER SCIENCE ANDENGINEERING,69,98,29
4980,"Einstein College of Engineering, Sir.C.V.Raman Nagar,Seethaparpanallur, Tirunelveli-627012.",EC,ELECTRONICS ANDCOMMUNICATIONENGINEERING,35,55,20
4980,"Einstein College of Engineering, Sir.C.V.Raman Nagar,Seethaparpanallur, Tirunelveli-627012.",EE,ELECTRICAL AND ELECTRONICSENGINEERING,35,55,20
4980,"Einstein College of Engineering, Sir.C.V.Raman Nagar,Seethaparpanallur, Tirunelveli-627012.",ME,MECHANICAL ENGINEERING,36,54,18
4981,"Ponjesly College of Engineering, Near Parvathipuram,Alamparai, Veturnimadam Post, Nagercoil-629003.",AD,Artificial Intelligence and DataScience,27,55,28
4981,"Ponjesly College of Engineering, Near Parvathipuram,Alamparai, Veturnimadam Post, Nagercoil-629003.",AM,COMPUTER SCIENCE ANDENGINEERING (AI ANDMACHINE LEARNING),0,26,26
4981,"Ponjesly College of Engineering, Near Parvathipuram,Alamparai, Veturnimadam Post, Nagercoil-629003.",CE,CIVIL  ENGINEERING,27,27,0
4981,"Ponjesly College of Engineering, Near Parvathipuram,Alamparai, Veturnimadam Post, Nagercoil-629003.",CS,COMPUTER SCIENCE ANDENGINEERING,52,55,3
4981,"Ponjesly College of Engineering, Near Parvathipuram,Alamparai, Veturnimadam Post, Nagercoil-629003.",EC,ELECTRONICS ANDCOMMUNICATIONENGINEERING,28,28,0
4981,"Ponjesly College of Engineering, Near Parvathipuram,Alamparai, Veturnimadam Post, Nagercoil-629003.",EE,ELECTRICAL AND ELECTRONICSENGINEERING,28,26,-2
4981,"Ponjesly College of Engineering, Near Parvathipuram,Alamparai, Veturnimadam Post, Nagercoil-629003.",IT,INFORMATION TECHNOLOGY,27,27,0
4981,"Ponjesly College of Engineering, Near Parvathipuram,Alamparai, Veturnimadam Post, Nagercoil-629003.",ME,MECHANICAL ENGINEERING,54,55,1
4982,"Vins Christian College of Engineering, Vins Nagar,Chunkankadai, Nagercoil, Kanyakumari-629807.",AD,Artificial Intelligence and DataScience,54,55,1
4982,"Vins Christian College of Engineering, Vins Nagar,Chunkankadai, Nagercoil, Kanyakumari-629807.",AM,COMPUTER SCIENCE ANDENGINEERING (AI ANDMACHINE LEARNING),26,26,0
4982,"Vins Christian College of Engineering, Vins Nagar,Chunkankadai, Nagercoil, Kanyakumari-629807.",CE,CIVIL  ENGINEERING,27,55,28
4982,"Vins Christian College of Engineering, Vins Nagar,Chunkankadai, Nagercoil, Kanyakumari-629807.",CS,COMPUTER SCIENCE ANDENGINEERING,55,55,0
4982,"Vins Christian College of Engineering, Vins Nagar,Chunkankadai, Nagercoil, Kanyakumari-629807.",EC,ELECTRONICS ANDCOMMUNICATIONENGINEERING,54,55,1
4982,"Vins Christian College of Engineering, Vins Nagar,Chunkankadai, Nagercoil, Kanyakumari-629807.",EE,ELECTRICAL AND ELECTRONICSENGINEERING,27,28,1
4982,"Vins Christian College of Engineering, Vins Nagar,Chunkankadai, Nagercoil, Kanyakumari-629807.",ME,MECHANICAL ENGINEERING,81,81,0
4982,"Vins Christian College of Engineering, Vins Nagar,Chunkankadai, Nagercoil, Kanyakumari-629807.",SC,Computer Science andEngineering (Cyber Security),28,26,-2
4983,"Lord Jegannath College of Engineering andTechnology, PSN Nagar, Ramanathichanputhur,Marungoor, Kanyakumari District, Nagercoil-629402.",AE,AERONAUTICAL ENGINEERING,22,27,5
4983,"Lord Jegannath College of Engineering andTechnology, PSN Nagar, Ramanathichanputhur,Marungoor, Kanyakumari District, Nagercoil-629402.",AG,AGRICULTURE ENGINEERING,45,54,9
4983,"Lord Jegannath College of Engineering andTechnology, PSN Nagar, Ramanathichanputhur,Marungoor, Kanyakumari District, Nagercoil-629402.",CE,CIVIL  ENGINEERING,45,55,10
4983,"Lord Jegannath College of Engineering andTechnology, PSN Nagar, Ramanathichanputhur,Marungoor, Kanyakumari District, Nagercoil-629402.",CS,COMPUTER SCIENCE ANDENGINEERING,46,55,9
4983,"Lord Jegannath College of Engineering andTechnology, PSN Nagar, Ramanathichanputhur,Marungoor, Kanyakumari District, Nagercoil-629402.",EC,ELECTRONICS ANDCOMMUNICATIONENGINEERING,24,27,3
4983,"Lord Jegannath College of Engineering andTechnology, PSN Nagar, Ramanathichanputhur,Marungoor, Kanyakumari District, Nagercoil-629402.",EE,ELECTRICAL AND ELECTRONICSENGINEERING,23,27,4
4983,"Lord Jegannath College of Engineering andTechnology, PSN Nagar, Ramanathichanputhur,Marungoor, Kanyakumari District, Nagercoil-629402.",ME,MECHANICAL ENGINEERING,46,55,9
4983,"Lord Jegannath College of Engineering andTechnology, PSN Nagar, Ramanathichanputhur,Marungoor, Kanyakumari District, Nagercoil-629402.",RM,ROBOTICS AND AUTOMATION,23,27,4
4984,"Marthandam College of Engineering and Technology,P.M.Village Road,Kuttakuzhi, Veeyannoor Post,Marthandam, Kanyakumari District-629177.",AD,Artificial Intelligence and DataScience,27,54,27
4984,"Marthandam College of Engineering and Technology,P.M.Village Road,Kuttakuzhi, Veeyannoor Post,Marthandam, Kanyakumari District-629177.",CE,CIVIL  ENGINEERING,27,27,0
4984,"Marthandam College of Engineering and Technology,P.M.Village Road,Kuttakuzhi, Veeyannoor Post,Marthandam, Kanyakumari District-629177.",CS,COMPUTER SCIENCE ANDENGINEERING,81,82,1
4984,"Marthandam College of Engineering and Technology,P.M.Village Road,Kuttakuzhi, Veeyannoor Post,Marthandam, Kanyakumari District-629177.",EC,ELECTRONICS ANDCOMMUNICATIONENGINEERING,55,54,-1
4984,"Marthandam College of Engineering and Technology,P.M.Village Road,Kuttakuzhi, Veeyannoor Post,Marthandam, Kanyakumari District-629177.",EE,ELECTRICAL AND ELECTRONICSENGINEERING,27,28,1
4984,"Marthandam College of Engineering and Technology,P.M.Village Road,Kuttakuzhi, Veeyannoor Post,Marthandam, Kanyakumari District-629177.",IT,INFORMATION TECHNOLOGY,55,54,-1
4984,"Marthandam College of Engineering and Technology,P.M.Village Road,Kuttakuzhi, Veeyannoor Post,Marthandam, Kanyakumari District-629177.",ME,MECHANICAL ENGINEERING,55,54,-1
4986,"Noorul Islam College of Engineering and Technology,Punkarai, Thiruvithancode (PO), Kanyakumari-629174.",AD,Artificial Intelligence and DataScience,35,35,0
4986,"Noorul Islam College of Engineering and Technology,Punkarai, Thiruvithancode (PO), Kanyakumari-629174.",CS,COMPUTER SCIENCE ANDENGINEERING,34,35,1
4986,"Noorul Islam College of Engineering and Technology,Punkarai, Thiruvithancode (PO), Kanyakumari-629174.",EC,ELECTRONICS ANDCOMMUNICATIONENGINEERING,35,36,1
4986,"Noorul Islam College of Engineering and Technology,Punkarai, Thiruvithancode (PO), Kanyakumari-629174.",EE,ELECTRICAL AND ELECTRONICSENGINEERING,18,18,0
4986,"Noorul Islam College of Engineering and Technology,Punkarai, Thiruvithancode (PO), Kanyakumari-629174.",IT,INFORMATION TECHNOLOGY,35,35,0
4986,"Noorul Islam College of Engineering and Technology,Punkarai, Thiruvithancode (PO), Kanyakumari-629174.",ME,MECHANICAL ENGINEERING,36,35,-1
4989,"PSN Engineering College, Melathediyoor,Palayamkottai, Tirunelveli-627152.",AD,Artificial Intelligence and DataScience,0,55,55
4989,"PSN Engineering College, Melathediyoor,Palayamkottai, Tirunelveli-627152.",AG,AGRICULTURE ENGINEERING,54,55,1
4989,"PSN Engineering College, Melathediyoor,Palayamkottai, Tirunelveli-627152.",AU,AUTOMOBILE ENGINEERING,55,27,-28
4989,"PSN Engineering College, Melathediyoor,Palayamkottai, Tirunelveli-627152.",BM,BIO MEDICAL ENGINEERING,0,27,27
4989,"PSN Engineering College, Melathediyoor,Palayamkottai, Tirunelveli-627152.",CE,CIVIL  ENGINEERING,55,54,-1
4989,"PSN Engineering College, Melathediyoor,Palayamkottai, Tirunelveli-627152.",CS,COMPUTER SCIENCE ANDENGINEERING,35,54,19
4989,"PSN Engineering College, Melathediyoor,Palayamkottai, Tirunelveli-627152.",EC,ELECTRONICS ANDCOMMUNICATIONENGINEERING,53,55,2
4989,"PSN Engineering College, Melathediyoor,Palayamkottai, Tirunelveli-627152.",IT,INFORMATION TECHNOLOGY,34,54,20
4989,"PSN Engineering College, Melathediyoor,Palayamkottai, Tirunelveli-627152.",ME,MECHANICAL ENGINEERING,55,55,0
4989,PSN Engineering College  Melathediyoor  TirunelveliDistrict 627152,MU,MECHANICAL ANDAUTOMATION ENGINEERING,55,0,-55
4992,"Bethlahem Institute of Engineering, Nadutheri,Karungal, Kanyakumari-629157.",AM,COMPUTER SCIENCE ANDENGINEERING (AI ANDMACHINE LEARNING),0,50,50
4992,"Bethlahem Institute of Engineering, Nadutheri,Karungal, Kanyakumari-629157.",CE,CIVIL  ENGINEERING,23,22,-1
4992,"Bethlahem Institute of Engineering, Nadutheri,Karungal, Kanyakumari-629157.",CS,COMPUTER SCIENCE ANDENGINEERING,45,50,5
4992,"Bethlahem Institute of Engineering, Nadutheri,Karungal, Kanyakumari-629157.",EC,ELECTRONICS ANDCOMMUNICATIONENGINEERING,50,50,0
4992,"Bethlahem Institute of Engineering, Nadutheri,Karungal, Kanyakumari-629157.",EE,ELECTRICAL AND ELECTRONICSENGINEERING,22,23,1
4992,"Bethlahem Institute of Engineering, Nadutheri,Karungal, Kanyakumari-629157.",IT,INFORMATION TECHNOLOGY,50,50,0
4992,"Bethlahem Institute of Engineering, Nadutheri,Karungal, Kanyakumari-629157.",ME,MECHANICAL ENGINEERING,50,50,0
4993,"Loyola Institute of Technology and Science, P.Bo.No.2, Thovalai - Rajavoor Road, Loyola Nagar,Theroor Village, Thovalai, Kanyakumari District-629302.",AD,Artificial Intelligence and DataScience,27,38,11
4993,"Loyola Institute of Technology and Science, P.Bo.No.2, Thovalai - Rajavoor Road, Loyola Nagar,Theroor Village, Thovalai, Kanyakumari District-629302.",AG,AGRICULTURE ENGINEERING,27,55,28
4993,"Loyola Institute of Technology and Science, P.Bo.No.2, Thovalai - Rajavoor Road, Loyola Nagar,Theroor Village, Thovalai, Kanyakumari District-629302.",AM,COMPUTER SCIENCE ANDENGINEERING (AI ANDMACHINE LEARNING),45,45,0
4993,"Loyola Institute of Technology and Science, P.Bo.No.2, Thovalai - Rajavoor Road, Loyola Nagar,Theroor Village, Thovalai, Kanyakumari District-629302.",BM,BIO MEDICAL ENGINEERING,45,36,-9
4993,"Loyola Institute of Technology and Science, P.Bo.No.2, Thovalai - Rajavoor Road, Loyola Nagar,Theroor Village, Thovalai, Kanyakumari District-629302.",CS,COMPUTER SCIENCE ANDENGINEERING,44,81,37
4993,"Loyola Institute of Technology and Science, P.Bo.No.2, Thovalai - Rajavoor Road, Loyola Nagar,Theroor Village, Thovalai, Kanyakumari District-629302.",EC,ELECTRONICS ANDCOMMUNICATIONENGINEERING,45,55,10
4993,"Loyola Institute of Technology and Science, P.Bo.No.2, Thovalai - Rajavoor Road, Loyola Nagar,Theroor Village, Thovalai, Kanyakumari District-629302.",EE,ELECTRICAL AND ELECTRONICSENGINEERING,55,54,-1
4993,"Loyola Institute of Technology and Science, P.Bo.No.2, Thovalai - Rajavoor Road, Loyola Nagar,Theroor Village, Thovalai, Kanyakumari District-629302.",IT,INFORMATION TECHNOLOGY,45,41,-4
4993,"Loyola Institute of Technology and Science, P.Bo.No.2, Thovalai - Rajavoor Road, Loyola Nagar,Theroor Village, Thovalai, Kanyakumari District-629302.",ME,MECHANICAL ENGINEERING,55,55,0
4994,"J.P. College of Engineering, College Road, Ayikudy,Tenkasi Taluk, Tirunelveli District-627852.",AD,Artificial Intelligence and DataScience,0,55,55
4994,"J.P. College of Engineering, College Road, Ayikudy,Tenkasi Taluk, Tirunelveli District-627852.",CE,CIVIL  ENGINEERING,17,18,1
4994,"J.P. College of Engineering, College Road, Ayikudy,Tenkasi Taluk, Tirunelveli District-627852.",CS,COMPUTER SCIENCE ANDENGINEERING,109,109,0
4994,"J.P. College of Engineering, College Road, Ayikudy,Tenkasi Taluk, Tirunelveli District-627852.",EC,ELECTRONICS ANDCOMMUNICATIONENGINEERING,55,45,-10
4994,"J.P. College of Engineering, College Road, Ayikudy,Tenkasi Taluk, Tirunelveli District-627852.",EE,ELECTRICAL AND ELECTRONICSENGINEERING,45,36,-9
4994,"J.P. College of Engineering, College Road, Ayikudy,Tenkasi Taluk, Tirunelveli District-627852.",IT,INFORMATION TECHNOLOGY,54,55,1
4994,"J.P. College of Engineering, College Road, Ayikudy,Tenkasi Taluk, Tirunelveli District-627852.",ME,MECHANICAL ENGINEERING,18,18,0
4995,"P.S.R.R College of Engineering, Appayanaickenpatti,Sevalpatti, Sivakasi, Virudhunagar -626140.",AD,Artificial Intelligence and DataScience,45,45,0
4995,"P.S.R.R College of Engineering, Appayanaickenpatti,Sevalpatti, Sivakasi, Virudhunagar -626140.",CS,COMPUTER SCIENCE ANDENGINEERING,27,36,9
4995,"P.S.R.R College of Engineering, Appayanaickenpatti,Sevalpatti, Sivakasi, Virudhunagar -626140.",EC,ELECTRONICS ANDCOMMUNICATIONENGINEERING,55,55,0
4995,"P.S.R.R College of Engineering, Appayanaickenpatti,Sevalpatti, Sivakasi, Virudhunagar -626140.",EE,ELECTRICAL AND ELECTRONICSENGINEERING,27,27,0
4996,"Sri Vidya College of Engineering and Technology,Sivakasi Main Road, P.Kumaralingapuram,Virudhunagar-626005.",AD,Artificial Intelligence and DataScience,35,45,10
4996,"Sri Vidya College of Engineering and Technology,Sivakasi Main Road, P.Kumaralingapuram,Virudhunagar-626005.",CB,COMPUTER SCIENCE ANDBUSSINESS SYSTEM,22,22,0
4996,"Sri Vidya College of Engineering and Technology,Sivakasi Main Road, P.Kumaralingapuram,Virudhunagar-626005.",CE,CIVIL  ENGINEERING,18,18,0
4996,"Sri Vidya College of Engineering and Technology,Sivakasi Main Road, P.Kumaralingapuram,Virudhunagar-626005.",CS,COMPUTER SCIENCE ANDENGINEERING,45,45,0
4996,"Sri Vidya College of Engineering and Technology,Sivakasi Main Road, P.Kumaralingapuram,Virudhunagar-626005.",EC,ELECTRONICS ANDCOMMUNICATIONENGINEERING,46,45,-1
4996,"Sri Vidya College of Engineering and Technology,Sivakasi Main Road, P.Kumaralingapuram,Virudhunagar-626005.",EE,ELECTRICAL AND ELECTRONICSENGINEERING,23,23,0
4996,"Sri Vidya College of Engineering and Technology,Sivakasi Main Road, P.Kumaralingapuram,Virudhunagar-626005.",ME,MECHANICAL ENGINEERING,35,35,0
4998,"Mahakavi Bharathiyar College of Engineering andTechnology, Kovil Nagar, Vasudevanallur, SivagiriTaluk, Tirunelveli District -627758.",CE,CIVIL  ENGINEERING,18,19,1
4998,"Mahakavi Bharathiyar College of Engineering andTechnology, Kovil Nagar, Vasudevanallur, SivagiriTaluk, Tirunelveli District -627758.",CS,COMPUTER SCIENCE ANDENGINEERING,17,20,3
4998,"Mahakavi Bharathiyar College of Engineering andTechnology, Kovil Nagar, Vasudevanallur, SivagiriTaluk, Tirunelveli District -627758.",EC,ELECTRONICS ANDCOMMUNICATIONENGINEERING,18,20,2
4998,"Mahakavi Bharathiyar College of Engineering andTechnology, Kovil Nagar, Vasudevanallur, SivagiriTaluk, Tirunelveli District -627758.",EE,ELECTRICAL AND ELECTRONICSENGINEERING,18,20,2
4998,"Mahakavi Bharathiyar College of Engineering andTechnology, Kovil Nagar, Vasudevanallur, SivagiriTaluk, Tirunelveli District -627758.",ME,MECHANICAL ENGINEERING,26,29,3
4999,"Annai Vailankanni College of Engineering, AVK Nagar,Pothaiyadisalai Pottalkulam, Azhagappapuram PO,Kanyakumari District, Nagercoil-629401.",AD,Artificial Intelligence and DataScience,40,45,5
4999,"Annai Vailankanni College of Engineering, AVK Nagar,Pothaiyadisalai Pottalkulam, Azhagappapuram PO,Kanyakumari District, Nagercoil-629401.",BM,BIO MEDICAL ENGINEERING,55,45,-10
4999,"Annai Vailankanni College of Engineering, AVK Nagar,Pothaiyadisalai Pottalkulam, Azhagappapuram PO,Kanyakumari District, Nagercoil-629401.",CS,COMPUTER SCIENCE ANDENGINEERING,41,46,5
4999,"Annai Vailankanni College of Engineering, AVK Nagar,Pothaiyadisalai Pottalkulam, Azhagappapuram PO,Kanyakumari District, Nagercoil-629401.",EC,ELECTRONICS ANDCOMMUNICATIONENGINEERING,41,45,4
4999,"Annai Vailankanni College of Engineering, AVK Nagar,Pothaiyadisalai Pottalkulam, Azhagappapuram PO,Kanyakumari District, Nagercoil-629401.",ME,MECHANICAL ENGINEERING,54,55,1
5008,Thiagarajar College of Engineering (Autonomous)Tirupparankundram  Madurai District 625015,CE,CIVIL  ENGINEERING,36,36,0
5008,Thiagarajar College of Engineering (Autonomous)Tirupparankundram  Madurai District 625015,CG,Computer Science andEngineering (ArtificialIntelligence and MachineLearning) (SS),0,38,38
5008,Thiagarajar College of Engineering (Autonomous)Tirupparankundram  Madurai District 625015,CM,COMPUTER SCIENCE ANDENGINEERING (SS),81,82,1
5008,Thiagarajar College of Engineering (Autonomous)Tirupparankundram  Madurai District 625015,CN,CIVIL  ENGINEERING (SS),51,51,0
5008,Thiagarajar College of Engineering (Autonomous)Tirupparankundram  Madurai District 625015,CS,COMPUTER SCIENCE ANDENGINEERING,43,45,2
5008,Thiagarajar College of Engineering (Autonomous)Tirupparankundram  Madurai District 625015,CW,Computer Science and BusinessSystem (SS),42,44,2
5008,Thiagarajar College of Engineering (Autonomous)Tirupparankundram  Madurai District 625015,EC,ELECTRONICS ANDCOMMUNICATIONENGINEERING,44,45,1
5008,Thiagarajar College of Engineering (Autonomous)Tirupparankundram  Madurai District 625015,EE,ELECTRICAL AND ELECTRONICSENGINEERING,46,45,-1
5008,Thiagarajar College of Engineering (Autonomous)Tirupparankundram  Madurai District 625015,EM,ELECTRONICS ANDCOMMUNICATIONENGINEERING (SS),81,82,1
5008,Thiagarajar College of Engineering (Autonomous)Tirupparankundram  Madurai District 625015,EY,ELECTRICAL AND ELECTRONICSENGINEERING (SS),45,44,-1
5008,Thiagarajar College of Engineering (Autonomous)Tirupparankundram  Madurai District 625015,ID,Interior Design (SS),0,19,19
5008,Thiagarajar College of Engineering (Autonomous)Tirupparankundram  Madurai District 625015,IM,INFORMATION TECHNOLOGY(SS),114,115,1
5008,Thiagarajar College of Engineering (Autonomous)Tirupparankundram  Madurai District 625015,ME,MECHANICAL ENGINEERING,45,46,1
5008,Thiagarajar College of Engineering (Autonomous)Tirupparankundram  Madurai District 625015,MF,MECHANICAL ENGINEERING(SS),44,44,0
5008,Thiagarajar College of Engineering (Autonomous)Tirupparankundram  Madurai District 625015,MG,MECHATRONICS (SS),38,38,0
5009,Government College of EngineeringMelachokkanathapuram  Bodinayakkanur  TheniDistrict 625582,CE,CIVIL  ENGINEERING,53,53,0
5009,Government College of EngineeringMelachokkanathapuram  Bodinayakkanur  TheniDistrict 625582,CS,COMPUTER SCIENCE ANDENGINEERING,53,55,2
5009,Government College of EngineeringMelachokkanathapuram  Bodinayakkanur  TheniDistrict 625582,EC,ELECTRONICS ANDCOMMUNICATIONENGINEERING,54,55,1
5009,Government College of EngineeringMelachokkanathapuram  Bodinayakkanur  TheniDistrict 625582,EE,ELECTRICAL AND ELECTRONICSENGINEERING,53,54,1
5009,Government College of EngineeringMelachokkanathapuram  Bodinayakkanur  TheniDistrict 625582,ME,MECHANICAL ENGINEERING,55,55,0
5010,Anna University Regional Campus - MaduraiKanyakumari National Highway  KeelakuilkudiMadurai District 625019,CE,CIVIL  ENGINEERING,54,54,0
5010,Anna University Regional Campus - MaduraiKanyakumari National Highway  KeelakuilkudiMadurai District 625019,CS,COMPUTER SCIENCE ANDENGINEERING,53,55,2
5010,Anna University Regional Campus - MaduraiKanyakumari National Highway  KeelakuilkudiMadurai District 625019,EC,ELECTRONICS ANDCOMMUNICATIONENGINEERING,53,55,2
5010,Anna University Regional Campus - MaduraiKanyakumari National Highway  KeelakuilkudiMadurai District 625019,EE,ELECTRICAL AND ELECTRONICSENGINEERING,54,54,0
5010,Anna University Regional Campus - MaduraiKanyakumari National Highway  KeelakuilkudiMadurai District 625019,ME,MECHANICAL ENGINEERING,55,54,-1
5012,Central Electrochemical Research Institute CECRI)Karaikudi  Sivagangai District 630006,CC,CHEMICAL AND ELECTROCHEMICAL  ENGINEERING (SS),30,31,1
5017,University College of Engineering  RamanathapuramPullangudi  Ramanathapuram District 623513,CE,CIVIL  ENGINEERING,53,27,-26
5017,University College of Engineering  RamanathapuramPullangudi  Ramanathapuram District 623513,CS,COMPUTER SCIENCE ANDENGINEERING,54,55,1
5017,University College of Engineering  RamanathapuramPullangudi  Ramanathapuram District 623513,EC,ELECTRONICS ANDCOMMUNICATIONENGINEERING,55,54,-1
5017,University College of Engineering  RamanathapuramPullangudi  Ramanathapuram District 623513,EF,Electrical and ComputerEngineering,0,26,26
5017,University College of Engineering  RamanathapuramPullangudi  Ramanathapuram District 623513,ME,MECHANICAL ENGINEERING,55,27,-28
5017,University College of Engineering  RamanathapuramPullangudi  Ramanathapuram District 623513,XC,CIVIL ENGINEERING (TAMILMEDIUM),27,28,1
5017,University College of Engineering  RamanathapuramPullangudi  Ramanathapuram District 623513,XM,MECHANICAL ENGINEERING(TAMIL MEDIUM),27,28,1
5022,University College of Engineering  Dindigul  MangaraiPirivu  Reddiyarchathiram  Dindigul District 624622,CE,CIVIL  ENGINEERING,55,55,0
5022,University College of Engineering  Dindigul  MangaraiPirivu  Reddiyarchathiram  Dindigul District 624622,CS,COMPUTER SCIENCE ANDENGINEERING,53,55,2
5022,University College of Engineering  Dindigul  MangaraiPirivu  Reddiyarchathiram  Dindigul District 624622,EC,ELECTRONICS ANDCOMMUNICATIONENGINEERING,55,55,0
5022,University College of Engineering  Dindigul  MangaraiPirivu  Reddiyarchathiram  Dindigul District 624622,EE,ELECTRICAL AND ELECTRONICSENGINEERING,54,54,0
5022,University College of Engineering  Dindigul  MangaraiPirivu  Reddiyarchathiram  Dindigul District 624622,ME,MECHANICAL ENGINEERING,55,54,-1
5022,University College of Engineering  Dindigul  MangaraiPirivu  Reddiyarchathiram  Dindigul District 624622,XC,CIVIL ENGINEERING (TAMILMEDIUM),27,27,0
5022,University College of Engineering  Dindigul  MangaraiPirivu  Reddiyarchathiram  Dindigul District 624622,XM,MECHANICAL ENGINEERING(TAMIL MEDIUM),27,27,0
5502,"Sri Raajaraajan College of Engineering andTechnology, No.146/4B1, Amaravathi Village,Amaravathypudhur(Post), Karaikudi Taluk, SivagangaiDistrict-630301.",AD,Artificial Intelligence and DataScience,17,18,1
5502,"Sri Raajaraajan College of Engineering andTechnology, No.146/4B1, Amaravathi Village,Amaravathypudhur(Post), Karaikudi Taluk, SivagangaiDistrict-630301.",AG,AGRICULTURE ENGINEERING,18,18,0
5502,"Sri Raajaraajan College of Engineering andTechnology, No.146/4B1, Amaravathi Village,Amaravathypudhur(Post), Karaikudi Taluk, SivagangaiDistrict-630301.",CE,CIVIL  ENGINEERING,18,18,0
5502,"Sri Raajaraajan College of Engineering andTechnology, No.146/4B1, Amaravathi Village,Amaravathypudhur(Post), Karaikudi Taluk, SivagangaiDistrict-630301.",CS,COMPUTER SCIENCE ANDENGINEERING,34,70,36
5502,"Sri Raajaraajan College of Engineering andTechnology, No.146/4B1, Amaravathi Village,Amaravathypudhur(Post), Karaikudi Taluk, SivagangaiDistrict-630301.",EC,ELECTRONICS ANDCOMMUNICATIONENGINEERING,35,35,0
5502,"Sri Raajaraajan College of Engineering andTechnology, No.146/4B1, Amaravathi Village,Amaravathypudhur(Post), Karaikudi Taluk, SivagangaiDistrict-630301.",EE,ELECTRICAL AND ELECTRONICSENGINEERING,18,18,0
5502,"Sri Raajaraajan College of Engineering andTechnology, No.146/4B1, Amaravathi Village,Amaravathypudhur(Post), Karaikudi Taluk, SivagangaiDistrict-630301.",ME,MECHANICAL ENGINEERING,36,35,-1
5530,"SSM Institute of Engineering and Technology,Kuttathupatti Village, Begambur Post, Dindigul Taluk& District-624002.",AD,Artificial Intelligence and DataScience,54,55,1
5530,"SSM Institute of Engineering and Technology,Kuttathupatti Village, Begambur Post, Dindigul Taluk& District-624002.",AM,COMPUTER SCIENCE ANDENGINEERING (AI ANDMACHINE LEARNING),0,54,54
5530,SSM Institute of Engineering and TechnologyKuttathupatti Village  Sindalaigundu Post  DindigulDistrict 624002,AU,AUTOMOBILE ENGINEERING,27,0,-27
5530,"SSM Institute of Engineering and Technology,Kuttathupatti Village, Begambur Post, Dindigul Taluk& District-624002.",CB,COMPUTER SCIENCE ANDBUSSINESS SYSTEM,55,54,-1
5530,"SSM Institute of Engineering and Technology,Kuttathupatti Village, Begambur Post, Dindigul Taluk& District-624002.",CE,CIVIL  ENGINEERING,27,28,1
5530,"SSM Institute of Engineering and Technology,Kuttathupatti Village, Begambur Post, Dindigul Taluk& District-624002.",CS,COMPUTER SCIENCE ANDENGINEERING,54,54,0
5530,"SSM Institute of Engineering and Technology,Kuttathupatti Village, Begambur Post, Dindigul Taluk& District-624002.",EC,ELECTRONICS ANDCOMMUNICATIONENGINEERING,108,54,-54
5530,"SSM Institute of Engineering and Technology,Kuttathupatti Village, Begambur Post, Dindigul Taluk& District-624002.",EE,ELECTRICAL AND ELECTRONICSENGINEERING,27,54,27
5530,"SSM Institute of Engineering and Technology,Kuttathupatti Village, Begambur Post, Dindigul Taluk& District-624002.",IT,INFORMATION TECHNOLOGY,54,54,0
5530,"SSM Institute of Engineering and Technology,Kuttathupatti Village, Begambur Post, Dindigul Taluk& District-624002.",ME,MECHANICAL ENGINEERING,27,28,1
5530,"SSM Institute of Engineering and Technology,Kuttathupatti Village, Begambur Post, Dindigul Taluk& District-624002.",SC,Computer Science andEngineering (Cyber Security),55,54,-1
5532,"Vaigai College of Engineering, Therkutheru, MelurTaluk, Madurai-625122.",CE,CIVIL  ENGINEERING,36,35,-1
5532,"Vaigai College of Engineering, Therkutheru, MelurTaluk, Madurai-625122.",CS,COMPUTER SCIENCE ANDENGINEERING,34,37,3
5532,"Vaigai College of Engineering, Therkutheru, MelurTaluk, Madurai-625122.",EC,ELECTRONICS ANDCOMMUNICATIONENGINEERING,35,45,10
5532,"Vaigai College of Engineering, Therkutheru, MelurTaluk, Madurai-625122.",EE,ELECTRICAL AND ELECTRONICSENGINEERING,35,45,10
5532,"Vaigai College of Engineering, Therkutheru, MelurTaluk, Madurai-625122.",ME,MECHANICAL ENGINEERING,36,35,-1
5533,"Karaikudi Institute of Technology & KaraikudiInstitute of Management, Keeranipatti Village,Thalakkavur Panchayat, Karaikudi, Sivaganga-630307.",CE,CIVIL  ENGINEERING,35,39,4
5533,"Karaikudi Institute of Technology & KaraikudiInstitute of Management, Keeranipatti Village,Thalakkavur Panchayat, Karaikudi, Sivaganga-630307.",CS,COMPUTER SCIENCE ANDENGINEERING,34,46,12
5533,"Karaikudi Institute of Technology & KaraikudiInstitute of Management, Keeranipatti Village,Thalakkavur Panchayat, Karaikudi, Sivaganga-630307.",EC,ELECTRONICS ANDCOMMUNICATIONENGINEERING,19,23,4
5533,"Karaikudi Institute of Technology & KaraikudiInstitute of Management, Keeranipatti Village,Thalakkavur Panchayat, Karaikudi, Sivaganga-630307.",EE,ELECTRICAL AND ELECTRONICSENGINEERING,18,22,4
5533,"Karaikudi Institute of Technology & KaraikudiInstitute of Management, Keeranipatti Village,Thalakkavur Panchayat, Karaikudi, Sivaganga-630307.",ME,MECHANICAL ENGINEERING,35,39,4
5536,"Mangayarkarasi College of Engineering, 7-1-139, 1stStreet, Mangayarkarasi Nagar, Paravai, Madurai-625402.",AG,AGRICULTURE ENGINEERING,55,54,-1
5536,"Mangayarkarasi College of Engineering, 7-1-139, 1stStreet, Mangayarkarasi Nagar, Paravai, Madurai-625402.",AM,COMPUTER SCIENCE ANDENGINEERING (AI ANDMACHINE LEARNING),34,36,2
5536,"Mangayarkarasi College of Engineering, 7-1-139, 1stStreet, Mangayarkarasi Nagar, Paravai, Madurai-625402.",CS,COMPUTER SCIENCE ANDENGINEERING,35,35,0
5536,"Mangayarkarasi College of Engineering, 7-1-139, 1stStreet, Mangayarkarasi Nagar, Paravai, Madurai-625402.",EC,ELECTRONICS ANDCOMMUNICATIONENGINEERING,55,50,-5
5536,"Mangayarkarasi College of Engineering, 7-1-139, 1stStreet, Mangayarkarasi Nagar, Paravai, Madurai-625402.",EE,ELECTRICAL AND ELECTRONICSENGINEERING,54,54,0
5536,"Mangayarkarasi College of Engineering, 7-1-139, 1stStreet, Mangayarkarasi Nagar, Paravai, Madurai-625402.",ME,MECHANICAL ENGINEERING,35,35,0
5537,"Jainee College of Engineering and Technology,Dindigul-Theni Main Road, (NHB Extn.),Aathupattiprivu, Veerakkal B.P.O.N. Panjampatti Post,Dindigul-624303.",AD,Artificial Intelligence and DataScience,0,27,27
5537,"Jainee College of Engineering and Technology,Dindigul-Theni Main Road, (NHB Extn.),Aathupattiprivu, Veerakkal B.P.O.N. Panjampatti Post,Dindigul-624303.",BM,BIO MEDICAL ENGINEERING,0,27,27
5537,"Jainee College of Engineering and Technology,Dindigul-Theni Main Road, (NHB Extn.),Aathupattiprivu, Veerakkal B.P.O.N. Panjampatti Post,Dindigul-624303.",CE,CIVIL  ENGINEERING,27,27,0
5537,"Jainee College of Engineering and Technology,Dindigul-Theni Main Road, (NHB Extn.),Aathupattiprivu, Veerakkal B.P.O.N. Panjampatti Post,Dindigul-624303.",CS,COMPUTER SCIENCE ANDENGINEERING,19,21,2
5537,"Jainee College of Engineering and Technology,Dindigul-Theni Main Road, (NHB Extn.),Aathupattiprivu, Veerakkal B.P.O.N. Panjampatti Post,Dindigul-624303.",EC,ELECTRONICS ANDCOMMUNICATIONENGINEERING,21,21,0
5537,"Jainee College of Engineering and Technology,Dindigul-Theni Main Road, (NHB Extn.),Aathupattiprivu, Veerakkal B.P.O.N. Panjampatti Post,Dindigul-624303.",EE,ELECTRICAL AND ELECTRONICSENGINEERING,21,21,0
5537,"Jainee College of Engineering and Technology,Dindigul-Theni Main Road, (NHB Extn.),Aathupattiprivu, Veerakkal B.P.O.N. Panjampatti Post,Dindigul-624303.",ME,MECHANICAL ENGINEERING,41,41,0
5703,"Christian College of Engineering and Technology,Near Check Post, Oddanchatram, Dindigul-624619.",AD,Artificial Intelligence and DataScience,26,19,-7
5703,"Christian College of Engineering and Technology,Near Check Post, Oddanchatram, Dindigul-624619.",AG,AGRICULTURE ENGINEERING,27,27,0
5703,"Christian College of Engineering and Technology,Near Check Post, Oddanchatram, Dindigul-624619.",AM,COMPUTER SCIENCE ANDENGINEERING (AI ANDMACHINE LEARNING),0,54,54
5703,"Christian College of Engineering and Technology,Near Check Post, Oddanchatram, Dindigul-624619.",CE,CIVIL  ENGINEERING,27,27,0
5703,"Christian College of Engineering and Technology,Near Check Post, Oddanchatram, Dindigul-624619.",CS,COMPUTER SCIENCE ANDENGINEERING,49,52,3
5703,"Christian College of Engineering and Technology,Near Check Post, Oddanchatram, Dindigul-624619.",EC,ELECTRONICS ANDCOMMUNICATIONENGINEERING,54,55,1
5703,"Christian College of Engineering and Technology,Near Check Post, Oddanchatram, Dindigul-624619.",EE,ELECTRICAL AND ELECTRONICSENGINEERING,54,27,-27
5703,"Christian College of Engineering and Technology,Near Check Post, Oddanchatram, Dindigul-624619.",IT,INFORMATION TECHNOLOGY,48,51,3
5703,"Christian College of Engineering and Technology,Near Check Post, Oddanchatram, Dindigul-624619.",ME,MECHANICAL ENGINEERING,55,28,-27
5832,"N.P.R College of Engineering and Technology(Autonomous), Punnappatti Village, Uluppakudi,Natham, Dindigul District-624401.",AD,Artificial Intelligence and DataScience,35,36,1
5832,"N.P.R College of Engineering and Technology(Autonomous), Punnappatti Village, Uluppakudi,Natham, Dindigul District-624401.",AM,COMPUTER SCIENCE ANDENGINEERING (AI ANDMACHINE LEARNING),0,54,54
5832,"N.P.R College of Engineering and Technology(Autonomous), Punnappatti Village, Uluppakudi,Natham, Dindigul District-624401.",CE,CIVIL  ENGINEERING,27,28,1
5832,"N.P.R College of Engineering and Technology(Autonomous), Punnappatti Village, Uluppakudi,Natham, Dindigul District-624401.",CS,COMPUTER SCIENCE ANDENGINEERING,70,76,6
5832,"N.P.R College of Engineering and Technology(Autonomous), Punnappatti Village, Uluppakudi,Natham, Dindigul District-624401.",EC,ELECTRONICS ANDCOMMUNICATIONENGINEERING,35,94,59
5832,"N.P.R College of Engineering and Technology(Autonomous), Punnappatti Village, Uluppakudi,Natham, Dindigul District-624401.",EE,ELECTRICAL AND ELECTRONICSENGINEERING,27,23,-4
5832,"N.P.R College of Engineering and Technology(Autonomous), Punnappatti Village, Uluppakudi,Natham, Dindigul District-624401.",IT,INFORMATION TECHNOLOGY,19,46,27
5832,"N.P.R College of Engineering and Technology(Autonomous), Punnappatti Village, Uluppakudi,Natham, Dindigul District-624401.",ME,MECHANICAL ENGINEERING,26,28,2
5842,"SRM Madurai College for Engineering andTechnology, Pottapalayam Village, ManamaduraiTaluk, Sivagangai District-630611.",AD,Artificial Intelligence and DataScience,35,70,35
5842,"SRM Madurai College for Engineering andTechnology, Pottapalayam Village, ManamaduraiTaluk, Sivagangai District-630611.",AM,COMPUTER SCIENCE ANDENGINEERING (AI ANDMACHINE LEARNING),35,35,0
5842,"SRM Madurai College for Engineering andTechnology, Pottapalayam Village, ManamaduraiTaluk, Sivagangai District-630611.",CE,CIVIL  ENGINEERING,35,24,-11
5842,"SRM Madurai College for Engineering andTechnology, Pottapalayam Village, ManamaduraiTaluk, Sivagangai District-630611.",CS,COMPUTER SCIENCE ANDENGINEERING,35,71,36
5842,"SRM Madurai College for Engineering andTechnology, Pottapalayam Village, ManamaduraiTaluk, Sivagangai District-630611.",EC,ELECTRONICS ANDCOMMUNICATIONENGINEERING,36,70,34
5842,"SRM Madurai College for Engineering andTechnology, Pottapalayam Village, ManamaduraiTaluk, Sivagangai District-630611.",EE,ELECTRICAL AND ELECTRONICSENGINEERING,18,17,-1
5842,"SRM Madurai College for Engineering andTechnology, Pottapalayam Village, ManamaduraiTaluk, Sivagangai District-630611.",IT,INFORMATION TECHNOLOGY,36,71,35
5842,"SRM Madurai College for Engineering andTechnology, Pottapalayam Village, ManamaduraiTaluk, Sivagangai District-630611.",ME,MECHANICAL ENGINEERING,18,24,6
5842,"SRM Madurai College for Engineering andTechnology, Pottapalayam Village, ManamaduraiTaluk, Sivagangai District-630611.",SC,Computer Science andEngineering (Cyber Security),33,35,2
5851,"Veerammal Engineering College, PVP Nagar,K.Singrakottai, Dindigul-624708.",CE,CIVIL  ENGINEERING,36,54,18
5851,"Veerammal Engineering College, PVP Nagar,K.Singrakottai, Dindigul-624708.",CS,COMPUTER SCIENCE ANDENGINEERING,35,54,19
5851,"Veerammal Engineering College, PVP Nagar,K.Singrakottai, Dindigul-624708.",EC,ELECTRONICS ANDCOMMUNICATIONENGINEERING,35,55,20
5851,"Veerammal Engineering College, PVP Nagar,K.Singrakottai, Dindigul-624708.",EE,ELECTRICAL AND ELECTRONICSENGINEERING,35,54,19
5862,"R V S Educational Trust's Group of Institutions, RVSNagar, N.Paraipatti Post, Dindigul-624005.",AE,AERONAUTICAL ENGINEERING,18,26,8
5862,"R V S Educational Trust's Group of Institutions, RVSNagar, N.Paraipatti Post, Dindigul-624005.",AG,AGRICULTURE ENGINEERING,35,53,18
5862,"R V S Educational Trust's Group of Institutions, RVSNagar, N.Paraipatti Post, Dindigul-624005.",AU,AUTOMOBILE ENGINEERING,18,27,9
5862,"R V S Educational Trust's Group of Institutions, RVSNagar, N.Paraipatti Post, Dindigul-624005.",BM,BIO MEDICAL ENGINEERING,41,49,8
5862,"R V S Educational Trust's Group of Institutions, RVSNagar, N.Paraipatti Post, Dindigul-624005.",CB,COMPUTER SCIENCE ANDBUSSINESS SYSTEM,22,25,3
5862,"R V S Educational Trust's Group of Institutions, RVSNagar, N.Paraipatti Post, Dindigul-624005.",CE,CIVIL  ENGINEERING,18,27,9
5862,"R V S Educational Trust's Group of Institutions, RVSNagar, N.Paraipatti Post, Dindigul-624005.",CS,COMPUTER SCIENCE ANDENGINEERING,34,50,16
5862,"R V S Educational Trust's Group of Institutions, RVSNagar, N.Paraipatti Post, Dindigul-624005.",ME,MECHANICAL ENGINEERING,19,28,9
5862,"R V S Educational Trust's Group of Institutions, RVSNagar, N.Paraipatti Post, Dindigul-624005.",SC,Computer Science andEngineering (Cyber Security),22,26,4
5865,"Nadar Saraswathi College of Engineering andTechnology, Vadapudupatti, Annanji Post, Theni -625531.",AD,Artificial Intelligence and DataScience,18,51,33
5865,"Nadar Saraswathi College of Engineering andTechnology, Vadapudupatti, Annanji Post, Theni -625531.",CE,CIVIL  ENGINEERING,54,53,-1
5865,"Nadar Saraswathi College of Engineering andTechnology, Vadapudupatti, Annanji Post, Theni -625531.",CS,COMPUTER SCIENCE ANDENGINEERING,34,46,12
5865,"Nadar Saraswathi College of Engineering andTechnology, Vadapudupatti, Annanji Post, Theni -625531.",EC,ELECTRONICS ANDCOMMUNICATIONENGINEERING,50,51,1
5865,"Nadar Saraswathi College of Engineering andTechnology, Vadapudupatti, Annanji Post, Theni -625531.",EE,ELECTRICAL AND ELECTRONICSENGINEERING,55,55,0
5865,"Nadar Saraswathi College of Engineering andTechnology, Vadapudupatti, Annanji Post, Theni -625531.",IT,INFORMATION TECHNOLOGY,18,51,33
5865,"Nadar Saraswathi College of Engineering andTechnology, Vadapudupatti, Annanji Post, Theni -625531.",ME,MECHANICAL ENGINEERING,54,54,0
5901,Alagappa Chettair Government College of Engineeringand Technology (Autonomous)  Karaikudi  SivagangaiDistrict 630004,CE,CIVIL  ENGINEERING,53,55,2
5901,Alagappa Chettair Government College of Engineeringand Technology (Autonomous)  Karaikudi  SivagangaiDistrict 630004,CS,COMPUTER SCIENCE ANDENGINEERING,53,55,2
5901,Alagappa Chettair Government College of Engineeringand Technology (Autonomous)  Karaikudi  SivagangaiDistrict 630004,EC,ELECTRONICS ANDCOMMUNICATIONENGINEERING,54,53,-1
5901,Alagappa Chettair Government College of Engineeringand Technology (Autonomous)  Karaikudi  SivagangaiDistrict 630004,EE,ELECTRICAL AND ELECTRONICSENGINEERING,107,109,2
5901,Alagappa Chettair Government College of Engineeringand Technology (Autonomous)  Karaikudi  SivagangaiDistrict 630004,ME,MECHANICAL ENGINEERING,109,108,-1
5902,"Bharath Niketan Engineering College, Shri GowriNagar, Thimmarasanaickanoor, Aundipatti, TheniDistrict-625536.",AD,Artificial Intelligence and DataScience,50,50,0
5902,"Bharath Niketan Engineering College, Shri GowriNagar, Thimmarasanaickanoor, Aundipatti, TheniDistrict-625536.",AG,AGRICULTURE ENGINEERING,0,18,18
5902,"Bharath Niketan Engineering College, Shri GowriNagar, Thimmarasanaickanoor, Aundipatti, TheniDistrict-625536.",CE,CIVIL  ENGINEERING,19,19,0
5902,"Bharath Niketan Engineering College, Shri GowriNagar, Thimmarasanaickanoor, Aundipatti, TheniDistrict-625536.",CS,COMPUTER SCIENCE ANDENGINEERING,48,50,2
5902,"Bharath Niketan Engineering College, Shri GowriNagar, Thimmarasanaickanoor, Aundipatti, TheniDistrict-625536.",EC,ELECTRONICS ANDCOMMUNICATIONENGINEERING,50,50,0
5902,"Bharath Niketan Engineering College, Shri GowriNagar, Thimmarasanaickanoor, Aundipatti, TheniDistrict-625536.",EE,ELECTRICAL AND ELECTRONICSENGINEERING,36,21,-15
5902,"Bharath Niketan Engineering College, Shri GowriNagar, Thimmarasanaickanoor, Aundipatti, TheniDistrict-625536.",IT,INFORMATION TECHNOLOGY,48,50,2
5902,"Bharath Niketan Engineering College, Shri GowriNagar, Thimmarasanaickanoor, Aundipatti, TheniDistrict-625536.",ME,MECHANICAL ENGINEERING,41,41,0
5904,"K.L.N.College of Engineering (Autonomous), Madurai -Nedunkulam Road, Pottapalayam, Sivagangai District-630611.",AD,Artificial Intelligence and DataScience,27,27,0
5904,"K.L.N.College of Engineering (Autonomous), Madurai -Nedunkulam Road, Pottapalayam, Sivagangai District-630611.",CI,Computer Science andEngineering (Internet of Things),31,27,-4
5904,"K.L.N.College of Engineering (Autonomous), Madurai -Nedunkulam Road, Pottapalayam, Sivagangai District-630611.",CS,COMPUTER SCIENCE ANDENGINEERING,55,55,0
5904,"K.L.N.College of Engineering (Autonomous), Madurai -Nedunkulam Road, Pottapalayam, Sivagangai District-630611.",EC,ELECTRONICS ANDCOMMUNICATIONENGINEERING,54,55,1
5904,"K.L.N.College of Engineering (Autonomous), Madurai -Nedunkulam Road, Pottapalayam, Sivagangai District-630611.",EE,ELECTRICAL AND ELECTRONICSENGINEERING,45,45,0
5904,"K.L.N.College of Engineering (Autonomous), Madurai -Nedunkulam Road, Pottapalayam, Sivagangai District-630611.",IT,INFORMATION TECHNOLOGY,40,41,1
5904,"K.L.N.College of Engineering (Autonomous), Madurai -Nedunkulam Road, Pottapalayam, Sivagangai District-630611.",ME,MECHANICAL ENGINEERING,45,45,0
5904,"K.L.N.College of Engineering (Autonomous), Madurai -Nedunkulam Road, Pottapalayam, Sivagangai District-630611.",SC,Computer Science andEngineering (Cyber Security),28,27,-1
5907,"Mohamed Sathak Engineering College, Sathak Nagar,East Coast Road, Pudhu Mayakulam, Kilakarai,Ramanathapuram District-623806.",AD,Artificial Intelligence and DataScience,27,27,0
5907,"Mohamed Sathak Engineering College, Sathak Nagar,East Coast Road, Pudhu Mayakulam, Kilakarai,Ramanathapuram District-623806.",AE,AERONAUTICAL ENGINEERING,28,14,-14
5907,"Mohamed Sathak Engineering College, Sathak Nagar,East Coast Road, Pudhu Mayakulam, Kilakarai,Ramanathapuram District-623806.",AG,AGRICULTURE ENGINEERING,14,14,0
5907,"Mohamed Sathak Engineering College, Sathak Nagar,East Coast Road, Pudhu Mayakulam, Kilakarai,Ramanathapuram District-623806.",AM,COMPUTER SCIENCE ANDENGINEERING (AI ANDMACHINE LEARNING),0,18,18
5907,"Mohamed Sathak Engineering College, Sathak Nagar,East Coast Road, Pudhu Mayakulam, Kilakarai,Ramanathapuram District-623806.",CB,COMPUTER SCIENCE ANDBUSSINESS SYSTEM,27,36,9
5907,"Mohamed Sathak Engineering College, Sathak Nagar,East Coast Road, Pudhu Mayakulam, Kilakarai,Ramanathapuram District-623806.",CE,CIVIL  ENGINEERING,27,14,-13
5907,"Mohamed Sathak Engineering College, Sathak Nagar,East Coast Road, Pudhu Mayakulam, Kilakarai,Ramanathapuram District-623806.",CH,CHEMICAL  ENGINEERING,21,19,-2
5907,"Mohamed Sathak Engineering College, Sathak Nagar,East Coast Road, Pudhu Mayakulam, Kilakarai,Ramanathapuram District-623806.",CS,COMPUTER SCIENCE ANDENGINEERING,39,50,11
5907,"Mohamed Sathak Engineering College, Sathak Nagar,East Coast Road, Pudhu Mayakulam, Kilakarai,Ramanathapuram District-623806.",EC,ELECTRONICS ANDCOMMUNICATIONENGINEERING,28,27,-1
5907,"Mohamed Sathak Engineering College, Sathak Nagar,East Coast Road, Pudhu Mayakulam, Kilakarai,Ramanathapuram District-623806.",EE,ELECTRICAL AND ELECTRONICSENGINEERING,27,27,0
5907,"Mohamed Sathak Engineering College, Sathak Nagar,East Coast Road, Pudhu Mayakulam, Kilakarai,Ramanathapuram District-623806.",IT,INFORMATION TECHNOLOGY,40,50,10
5907,"Mohamed Sathak Engineering College, Sathak Nagar,East Coast Road, Pudhu Mayakulam, Kilakarai,Ramanathapuram District-623806.",ME,MECHANICAL ENGINEERING,27,27,0
5907,"Mohamed Sathak Engineering College, Sathak Nagar,East Coast Road, Pudhu Mayakulam, Kilakarai,Ramanathapuram District-623806.",MR,MARINE ENGINEERING,14,14,0
5907,"Mohamed Sathak Engineering College, Sathak Nagar,East Coast Road, Pudhu Mayakulam, Kilakarai,Ramanathapuram District-623806.",SC,Computer Science andEngineering (Cyber Security),0,18,18
5910,"PSNA College of Engineering and Technology(Autonomous), Kothandaraman Nagar,Muthanampatti (PO), Dindigul-624622.",AD,Artificial Intelligence and DataScience,35,35,0
5910,"PSNA College of Engineering and Technology(Autonomous), Kothandaraman Nagar,Muthanampatti (PO), Dindigul-624622.",AM,COMPUTER SCIENCE ANDENGINEERING (AI ANDMACHINE LEARNING),0,35,35
5910,"PSNA College of Engineering and Technology(Autonomous), Kothandaraman Nagar,Muthanampatti (PO), Dindigul-624622.",BM,BIO MEDICAL ENGINEERING,35,36,1
5910,"PSNA College of Engineering and Technology(Autonomous), Kothandaraman Nagar,Muthanampatti (PO), Dindigul-624622.",CB,COMPUTER SCIENCE ANDBUSSINESS SYSTEM,35,35,0
5910,"PSNA College of Engineering and Technology(Autonomous), Kothandaraman Nagar,Muthanampatti (PO), Dindigul-624622.",CE,CIVIL  ENGINEERING,36,35,-1
5910,"PSNA College of Engineering and Technology(Autonomous), Kothandaraman Nagar,Muthanampatti (PO), Dindigul-624622.",CS,COMPUTER SCIENCE ANDENGINEERING,139,142,3
5910,"PSNA College of Engineering and Technology(Autonomous), Kothandaraman Nagar,Muthanampatti (PO), Dindigul-624622.",EC,ELECTRONICS ANDCOMMUNICATIONENGINEERING,142,142,0
5910,"PSNA College of Engineering and Technology(Autonomous), Kothandaraman Nagar,Muthanampatti (PO), Dindigul-624622.",EE,ELECTRICAL AND ELECTRONICSENGINEERING,54,53,-1
5910,"PSNA College of Engineering and Technology(Autonomous), Kothandaraman Nagar,Muthanampatti (PO), Dindigul-624622.",EV,Electronics Engineering (VLSIDesign and Technology),0,36,36
5910,"PSNA College of Engineering and Technology(Autonomous), Kothandaraman Nagar,Muthanampatti (PO), Dindigul-624622.",IT,INFORMATION TECHNOLOGY,106,105,-1
5910,"PSNA College of Engineering and Technology(Autonomous), Kothandaraman Nagar,Muthanampatti (PO), Dindigul-624622.",ME,MECHANICAL ENGINEERING,69,70,1
5910,"PSNA College of Engineering and Technology(Autonomous), Kothandaraman Nagar,Muthanampatti (PO), Dindigul-624622.",SC,Computer Science andEngineering (Cyber Security),35,35,0
5911,"P.T.R. College of Engineering and Technology,Thanapandiyan Nagar, Madurai - Tirumangalam Road,Madurai-625008.",AD,Artificial Intelligence and DataScience,0,28,28
5911,"P.T.R. College of Engineering and Technology,Thanapandiyan Nagar, Madurai - Tirumangalam Road,Madurai-625008.",BM,BIO MEDICAL ENGINEERING,0,27,27
5911,"P.T.R. College of Engineering and Technology,Thanapandiyan Nagar, Madurai - Tirumangalam Road,Madurai-625008.",CB,COMPUTER SCIENCE ANDBUSSINESS SYSTEM,0,27,27
5911,"P.T.R. College of Engineering and Technology,Thanapandiyan Nagar, Madurai - Tirumangalam Road,Madurai-625008.",CE,CIVIL  ENGINEERING,27,27,0
5911,"P.T.R. College of Engineering and Technology,Thanapandiyan Nagar, Madurai - Tirumangalam Road,Madurai-625008.",CS,COMPUTER SCIENCE ANDENGINEERING,23,23,0
5911,"P.T.R. College of Engineering and Technology,Thanapandiyan Nagar, Madurai - Tirumangalam Road,Madurai-625008.",EC,ELECTRONICS ANDCOMMUNICATIONENGINEERING,26,27,1
5911,"P.T.R. College of Engineering and Technology,Thanapandiyan Nagar, Madurai - Tirumangalam Road,Madurai-625008.",EE,ELECTRICAL AND ELECTRONICSENGINEERING,13,14,1
5911,"P.T.R. College of Engineering and Technology,Thanapandiyan Nagar, Madurai - Tirumangalam Road,Madurai-625008.",ME,MECHANICAL ENGINEERING,27,27,0
5911,"P.T.R. College of Engineering and Technology,Thanapandiyan Nagar, Madurai - Tirumangalam Road,Madurai-625008.",SC,Computer Science andEngineering (Cyber Security),0,27,27
5912,"Pandian Saraswathi Yadav Engineering College,Arasanoor Village, Thirumansolai Post, SivaganagiDistrict-630561.",AD,Artificial Intelligence and DataScience,27,28,1
5912,"Pandian Saraswathi Yadav Engineering College,Arasanoor Village, Thirumansolai Post, SivaganagiDistrict-630561.",AM,COMPUTER SCIENCE ANDENGINEERING (AI ANDMACHINE LEARNING),27,28,1
5912,"Pandian Saraswathi Yadav Engineering College,Arasanoor Village, Thirumansolai Post, SivaganagiDistrict-630561.",CE,CIVIL  ENGINEERING,27,28,1
5912,"Pandian Saraswathi Yadav Engineering College,Arasanoor Village, Thirumansolai Post, SivaganagiDistrict-630561.",CS,COMPUTER SCIENCE ANDENGINEERING,81,81,0
5912,"Pandian Saraswathi Yadav Engineering College,Arasanoor Village, Thirumansolai Post, SivaganagiDistrict-630561.",EC,ELECTRONICS ANDCOMMUNICATIONENGINEERING,27,53,26
5912,"Pandian Saraswathi Yadav Engineering College,Arasanoor Village, Thirumansolai Post, SivaganagiDistrict-630561.",EE,ELECTRICAL AND ELECTRONICSENGINEERING,27,27,0
5912,"Pandian Saraswathi Yadav Engineering College,Arasanoor Village, Thirumansolai Post, SivaganagiDistrict-630561.",IT,INFORMATION TECHNOLOGY,28,27,-1
5912,"Pandian Saraswathi Yadav Engineering College,Arasanoor Village, Thirumansolai Post, SivaganagiDistrict-630561.",ME,MECHANICAL ENGINEERING,27,27,0
5912,Pandian Saraswathi Yadav Engineering CollegeThirumansolai Post  Sivagangai District 630 561,RM,ROBOTICS AND AUTOMATION,27,0,-27
5912,"Pandian Saraswathi Yadav Engineering College,Arasanoor Village, Thirumansolai Post, SivaganagiDistrict-630561.",SC,Computer Science andEngineering (Cyber Security),27,28,1
5913,"R.V.S. College of Engineering, RVS Nagar, Karur Road,N.Paraipatti Post, Dindigul-624005.",AD,Artificial Intelligence and DataScience,20,24,4
5913,"R.V.S. College of Engineering, RVS Nagar, Karur Road,N.Paraipatti Post, Dindigul-624005.",CE,CIVIL  ENGINEERING,20,27,7
5913,"R.V.S. College of Engineering, RVS Nagar, Karur Road,N.Paraipatti Post, Dindigul-624005.",CH,CHEMICAL  ENGINEERING,0,26,26
5913,"R.V.S. College of Engineering, RVS Nagar, Karur Road,N.Paraipatti Post, Dindigul-624005.",CO,COMPUTER ANDCOMMUNICATIONENGINEERING,0,24,24
5913,"R.V.S. College of Engineering, RVS Nagar, Karur Road,N.Paraipatti Post, Dindigul-624005.",CS,COMPUTER SCIENCE ANDENGINEERING,41,50,9
5913,"R.V.S. College of Engineering, RVS Nagar, Karur Road,N.Paraipatti Post, Dindigul-624005.",EC,ELECTRONICS ANDCOMMUNICATIONENGINEERING,42,54,12
5913,"R.V.S. College of Engineering, RVS Nagar, Karur Road,N.Paraipatti Post, Dindigul-624005.",EE,ELECTRICAL AND ELECTRONICSENGINEERING,19,25,6
5913,"R.V.S. College of Engineering, RVS Nagar, Karur Road,N.Paraipatti Post, Dindigul-624005.",FT,FASHION TECHNOLOGY,0,28,28
5913,"R.V.S. College of Engineering, RVS Nagar, Karur Road,N.Paraipatti Post, Dindigul-624005.",IT,INFORMATION TECHNOLOGY,41,74,33
5913,"R.V.S. College of Engineering, RVS Nagar, Karur Road,N.Paraipatti Post, Dindigul-624005.",ME,MECHANICAL ENGINEERING,20,28,8
5913,"R.V.S. College of Engineering, RVS Nagar, Karur Road,N.Paraipatti Post, Dindigul-624005.",PC,PETRO CHEMICALTECHNOLOGY,21,26,5
5913,"R.V.S. College of Engineering, RVS Nagar, Karur Road,N.Paraipatti Post, Dindigul-624005.",TX,TEXTILE TECHNOLOGY,21,27,6
5914,"Solamalai College of Engineering , S.V Raja Nagar,Veerapanjan, Madurai-625020.",AD,Artificial Intelligence and DataScience,34,35,1
5914,"Solamalai College of Engineering , S.V Raja Nagar,Veerapanjan, Madurai-625020.",CB,COMPUTER SCIENCE ANDBUSSINESS SYSTEM,35,35,0
5914,"Solamalai College of Engineering , S.V Raja Nagar,Veerapanjan, Madurai-625020.",CE,CIVIL  ENGINEERING,19,18,-1
5914,"Solamalai College of Engineering , S.V Raja Nagar,Veerapanjan, Madurai-625020.",CS,COMPUTER SCIENCE ANDENGINEERING,35,36,1
5914,"Solamalai College of Engineering , S.V Raja Nagar,Veerapanjan, Madurai-625020.",EC,ELECTRONICS ANDCOMMUNICATIONENGINEERING,35,35,0
5914,"Solamalai College of Engineering , S.V Raja Nagar,Veerapanjan, Madurai-625020.",EE,ELECTRICAL AND ELECTRONICSENGINEERING,18,17,-1
5914,"Solamalai College of Engineering , S.V Raja Nagar,Veerapanjan, Madurai-625020.",ME,MECHANICAL ENGINEERING,18,18,0
5915,"SACS M.A.V.M.M. Engineering College, 446, Melur -Alagarkoil Road, Kidaripatti (PO), Alagarkoil Via,Melur Taluk, Madurai-625301.",CE,CIVIL  ENGINEERING,53,55,2
5915,"SACS M.A.V.M.M. Engineering College, 446, Melur -Alagarkoil Road, Kidaripatti (PO), Alagarkoil Via,Melur Taluk, Madurai-625301.",CS,COMPUTER SCIENCE ANDENGINEERING,34,35,1
5915,"SACS M.A.V.M.M. Engineering College, 446, Melur -Alagarkoil Road, Kidaripatti (PO), Alagarkoil Via,Melur Taluk, Madurai-625301.",EC,ELECTRONICS ANDCOMMUNICATIONENGINEERING,55,54,-1
5915,"SACS M.A.V.M.M. Engineering College, 446, Melur -Alagarkoil Road, Kidaripatti (PO), Alagarkoil Via,Melur Taluk, Madurai-625301.",EE,ELECTRICAL AND ELECTRONICSENGINEERING,54,55,1
5915,"SACS M.A.V.M.M. Engineering College, 446, Melur -Alagarkoil Road, Kidaripatti (PO), Alagarkoil Via,Melur Taluk, Madurai-625301.",ME,MECHANICAL ENGINEERING,55,54,-1
5919,"St. Michael College of Engineering and Technology,St. Santhiagaper Nagar, Kalayarkoil, Sivaganga District630551.",AM,COMPUTER SCIENCE ANDENGINEERING (AI ANDMACHINE LEARNING),50,50,0
5919,"St. Michael College of Engineering and Technology,St. Santhiagaper Nagar, Kalayarkoil, Sivaganga District630551.",BM,BIO MEDICAL ENGINEERING,26,27,1
5919,"St. Michael College of Engineering and Technology,St. Santhiagaper Nagar, Kalayarkoil, Sivaganga District630551.",BT,BIO TECHNOLOGY,50,50,0
5919,"St. Michael College of Engineering and Technology,St. Santhiagaper Nagar, Kalayarkoil, Sivaganga District630551.",CH,CHEMICAL  ENGINEERING,27,27,0
5919,"St. Michael College of Engineering and Technology,St. Santhiagaper Nagar, Kalayarkoil, Sivaganga District630551.",CS,COMPUTER SCIENCE ANDENGINEERING,50,50,0
5919,"St. Michael College of Engineering and Technology,St. Santhiagaper Nagar, Kalayarkoil, Sivaganga District630551.",EC,ELECTRONICS ANDCOMMUNICATIONENGINEERING,54,55,1
5919,"St. Michael College of Engineering and Technology,St. Santhiagaper Nagar, Kalayarkoil, Sivaganga District630551.",EE,ELECTRICAL AND ELECTRONICSENGINEERING,27,27,0
5919,"St. Michael College of Engineering and Technology,St. Santhiagaper Nagar, Kalayarkoil, Sivaganga District630551.",ME,MECHANICAL ENGINEERING,28,27,-1
5921,"Syed Ammal Engineering College (Autonomous), Dr.E.M.Abdullah Campus, Lanthai, Achunthanvayal Post,Ramanathapuram-623502.",AD,Artificial Intelligence and DataScience,27,27,0
5921,"Syed Ammal Engineering College (Autonomous), Dr.E.M.Abdullah Campus, Lanthai, Achunthanvayal Post,Ramanathapuram-623502.",BM,BIO MEDICAL ENGINEERING,22,19,-3
5921,"Syed Ammal Engineering College (Autonomous), Dr.E.M.Abdullah Campus, Lanthai, Achunthanvayal Post,Ramanathapuram-623502.",CB,COMPUTER SCIENCE ANDBUSSINESS SYSTEM,22,20,-2
5921,"Syed Ammal Engineering College (Autonomous), Dr.E.M.Abdullah Campus, Lanthai, Achunthanvayal Post,Ramanathapuram-623502.",CE,CIVIL  ENGINEERING,22,22,0
5921,"Syed Ammal Engineering College (Autonomous), Dr.E.M.Abdullah Campus, Lanthai, Achunthanvayal Post,Ramanathapuram-623502.",CS,COMPUTER SCIENCE ANDENGINEERING,73,41,-32
5921,"Syed Ammal Engineering College (Autonomous), Dr.E.M.Abdullah Campus, Lanthai, Achunthanvayal Post,Ramanathapuram-623502.",EC,ELECTRONICS ANDCOMMUNICATIONENGINEERING,14,16,2
5921,"Syed Ammal Engineering College (Autonomous), Dr.E.M.Abdullah Campus, Lanthai, Achunthanvayal Post,Ramanathapuram-623502.",EE,ELECTRICAL AND ELECTRONICSENGINEERING,23,17,-6
5921,"Syed Ammal Engineering College (Autonomous), Dr.E.M.Abdullah Campus, Lanthai, Achunthanvayal Post,Ramanathapuram-623502.",IT,INFORMATION TECHNOLOGY,0,18,18
5921,"Syed Ammal Engineering College (Autonomous), Dr.E.M.Abdullah Campus, Lanthai, Achunthanvayal Post,Ramanathapuram-623502.",ME,MECHANICAL ENGINEERING,23,19,-4
5924,"Ganapathy Chettiar College of Engineering andTechnology, Melakavanur (PO), Paramakudi,Ramanathapuram District-623706.",AD,Artificial Intelligence and DataScience,0,18,18
5924,"Ganapathy Chettiar College of Engineering andTechnology, Melakavanur (PO), Paramakudi,Ramanathapuram District-623706.",CE,CIVIL  ENGINEERING,36,35,-1
5924,"Ganapathy Chettiar College of Engineering andTechnology, Melakavanur (PO), Paramakudi,Ramanathapuram District-623706.",CS,COMPUTER SCIENCE ANDENGINEERING,35,35,0
5924,"Ganapathy Chettiar College of Engineering andTechnology, Melakavanur (PO), Paramakudi,Ramanathapuram District-623706.",EC,ELECTRONICS ANDCOMMUNICATIONENGINEERING,35,35,0
5924,"Ganapathy Chettiar College of Engineering andTechnology, Melakavanur (PO), Paramakudi,Ramanathapuram District-623706.",EE,ELECTRICAL AND ELECTRONICSENGINEERING,36,35,-1
5924,"Ganapathy Chettiar College of Engineering andTechnology, Melakavanur (PO), Paramakudi,Ramanathapuram District-623706.",IT,INFORMATION TECHNOLOGY,14,14,0
5924,"Ganapathy Chettiar College of Engineering andTechnology, Melakavanur (PO), Paramakudi,Ramanathapuram District-623706.",ME,MECHANICAL ENGINEERING,35,35,0
5930,"SBM College of Engineering and Technology, SBMNagar, Thamaraipadi(PO), Trichy Road, Dindigul-624005.",AD,Artificial Intelligence and DataScience,0,26,26
5930,"SBM College of Engineering and Technology, SBMNagar, Thamaraipadi(PO), Trichy Road, Dindigul-624005.",BM,BIO MEDICAL ENGINEERING,0,27,27
5930,"SBM College of Engineering and Technology, SBMNagar, Thamaraipadi(PO), Trichy Road, Dindigul-624005.",CE,CIVIL  ENGINEERING,106,80,-26
5930,"SBM College of Engineering and Technology, SBMNagar, Thamaraipadi(PO), Trichy Road, Dindigul-624005.",CS,COMPUTER SCIENCE ANDENGINEERING,54,81,27
5930,"SBM College of Engineering and Technology, SBMNagar, Thamaraipadi(PO), Trichy Road, Dindigul-624005.",EC,ELECTRONICS ANDCOMMUNICATIONENGINEERING,107,80,-27
5930,"SBM College of Engineering and Technology, SBMNagar, Thamaraipadi(PO), Trichy Road, Dindigul-624005.",EE,ELECTRICAL AND ELECTRONICSENGINEERING,54,53,-1
5930,"SBM College of Engineering and Technology, SBMNagar, Thamaraipadi(PO), Trichy Road, Dindigul-624005.",IT,INFORMATION TECHNOLOGY,0,26,26
5930,"SBM College of Engineering and Technology, SBMNagar, Thamaraipadi(PO), Trichy Road, Dindigul-624005.",ME,MECHANICAL ENGINEERING,135,80,-55
5935,"Fatima Michael College of Engineering andTechnology, Senkottai Village, KalimangalamPanchayat,Sivaganga Main Road, Madurai-625020.",AM,COMPUTER SCIENCE ANDENGINEERING (AI ANDMACHINE LEARNING),22,44,22
5935,"Fatima Michael College of Engineering andTechnology, Senkottai Village, KalimangalamPanchayat,Sivaganga Main Road, Madurai-625020.",AU,AUTOMOBILE ENGINEERING,26,23,-3
5935,"Fatima Michael College of Engineering andTechnology, Senkottai Village, KalimangalamPanchayat,Sivaganga Main Road, Madurai-625020.",CE,CIVIL  ENGINEERING,53,22,-31
5935,"Fatima Michael College of Engineering andTechnology, Senkottai Village, KalimangalamPanchayat,Sivaganga Main Road, Madurai-625020.",CS,COMPUTER SCIENCE ANDENGINEERING,44,44,0
5935,"Fatima Michael College of Engineering andTechnology, Senkottai Village, KalimangalamPanchayat,Sivaganga Main Road, Madurai-625020.",EC,ELECTRONICS ANDCOMMUNICATIONENGINEERING,46,46,0
5935,"Fatima Michael College of Engineering andTechnology, Senkottai Village, KalimangalamPanchayat,Sivaganga Main Road, Madurai-625020.",EE,ELECTRICAL AND ELECTRONICSENGINEERING,23,23,0
5935,"Fatima Michael College of Engineering andTechnology, Senkottai Village, KalimangalamPanchayat,Sivaganga Main Road, Madurai-625020.",ME,MECHANICAL ENGINEERING,25,24,-1
5935,"Fatima Michael College of Engineering andTechnology, Senkottai Village, KalimangalamPanchayat,Sivaganga Main Road, Madurai-625020.",SC,Computer Science andEngineering (Cyber Security),20,23,3
5942,"Ultra College of Engineering and Technology , 69/1,Ultra Nagar, Kodikulam I Bit, Madurai - ChennaiHighway, Madurai-625104.",CE,CIVIL  ENGINEERING,22,22,0
5942,"Ultra College of Engineering and Technology , 69/1,Ultra Nagar, Kodikulam I Bit, Madurai - ChennaiHighway, Madurai-625104.",CS,COMPUTER SCIENCE ANDENGINEERING,45,54,9
5942,"Ultra College of Engineering and Technology , 69/1,Ultra Nagar, Kodikulam I Bit, Madurai - ChennaiHighway, Madurai-625104.",EC,ELECTRONICS ANDCOMMUNICATIONENGINEERING,44,45,1
5942,"Ultra College of Engineering and Technology , 69/1,Ultra Nagar, Kodikulam I Bit, Madurai - ChennaiHighway, Madurai-625104.",EE,ELECTRICAL AND ELECTRONICSENGINEERING,23,21,-2
5942,"Ultra College of Engineering and Technology , 69/1,Ultra Nagar, Kodikulam I Bit, Madurai - ChennaiHighway, Madurai-625104.",IT,INFORMATION TECHNOLOGY,22,28,6
5942,"Ultra College of Engineering and Technology , 69/1,Ultra Nagar, Kodikulam I Bit, Madurai - ChennaiHighway, Madurai-625104.",ME,MECHANICAL ENGINEERING,22,19,-3
5986,"Velammal College of Engineering and Technology(Autonomous), Velammal Nagar, Viraganoor,Madurai -625009.",AD,Artificial Intelligence and DataScience,35,37,2
5986,"Velammal College of Engineering and Technology(Autonomous), Velammal Nagar, Viraganoor,Madurai -625009.",CE,CIVIL  ENGINEERING,34,35,1
5986,"Velammal College of Engineering and Technology(Autonomous), Velammal Nagar, Viraganoor,Madurai -625009.",CS,COMPUTER SCIENCE ANDENGINEERING,105,105,0
5986,"Velammal College of Engineering and Technology(Autonomous), Velammal Nagar, Viraganoor,Madurai -625009.",EC,ELECTRONICS ANDCOMMUNICATIONENGINEERING,71,105,34
5986,"Velammal College of Engineering and Technology(Autonomous), Velammal Nagar, Viraganoor,Madurai -625009.",EE,ELECTRICAL AND ELECTRONICSENGINEERING,35,35,0
5986,"Velammal College of Engineering and Technology(Autonomous), Velammal Nagar, Viraganoor,Madurai -625009.",EV,Electronics Engineering (VLSIDesign and Technology),0,35,35
5986,"Velammal College of Engineering and Technology(Autonomous), Velammal Nagar, Viraganoor,Madurai -625009.",IT,INFORMATION TECHNOLOGY,71,71,0
5986,"Velammal College of Engineering and Technology(Autonomous), Velammal Nagar, Viraganoor,Madurai -625009.",ME,MECHANICAL ENGINEERING,35,36,1
5986,"Velammal College of Engineering and Technology(Autonomous), Velammal Nagar, Viraganoor,Madurai -625009.",SC,Computer Science andEngineering (Cyber Security),0,36,36
5988,"Theni Kammavar Sangam College of Technology,Theni Main road, Koduvilarpatti (PO),Veerapandi(Via), Theni District-625534.",AM,COMPUTER SCIENCE ANDENGINEERING (AI ANDMACHINE LEARNING),0,45,45
5988,"Theni Kammavar Sangam College of Technology,Theni Main road, Koduvilarpatti (PO),Veerapandi(Via), Theni District-625534.",CE,CIVIL  ENGINEERING,23,28,5
5988,"Theni Kammavar Sangam College of Technology,Theni Main road, Koduvilarpatti (PO),Veerapandi(Via), Theni District-625534.",CS,COMPUTER SCIENCE ANDENGINEERING,35,35,0
5988,"Theni Kammavar Sangam College of Technology,Theni Main road, Koduvilarpatti (PO),Veerapandi(Via), Theni District-625534.",EC,ELECTRONICS ANDCOMMUNICATIONENGINEERING,45,50,5
5988,"Theni Kammavar Sangam College of Technology,Theni Main road, Koduvilarpatti (PO),Veerapandi(Via), Theni District-625534.",EE,ELECTRICAL AND ELECTRONICSENGINEERING,46,55,9
5988,"Theni Kammavar Sangam College of Technology,Theni Main road, Koduvilarpatti (PO),Veerapandi(Via), Theni District-625534.",IT,INFORMATION TECHNOLOGY,36,45,9
5988,"Theni Kammavar Sangam College of Technology,Theni Main road, Koduvilarpatti (PO),Veerapandi(Via), Theni District-625534.",ME,MECHANICAL ENGINEERING,45,54,9
5990,"Latha Mathavan Engineering College, Latha MathavanNagar, Kidaripatti, Melur Taluk, Madurai-625301.",CE,CIVIL  ENGINEERING,73,44,-29
5990,"Latha Mathavan Engineering College, Latha MathavanNagar, Kidaripatti, Melur Taluk, Madurai-625301.",CS,COMPUTER SCIENCE ANDENGINEERING,72,71,-1
5990,"Latha Mathavan Engineering College, Latha MathavanNagar, Kidaripatti, Melur Taluk, Madurai-625301.",EC,ELECTRONICS ANDCOMMUNICATIONENGINEERING,36,36,0
5990,"Latha Mathavan Engineering College, Latha MathavanNagar, Kidaripatti, Melur Taluk, Madurai-625301.",EE,ELECTRICAL AND ELECTRONICSENGINEERING,36,26,-10
5990,"Latha Mathavan Engineering College, Latha MathavanNagar, Kidaripatti, Melur Taluk, Madurai-625301.",ME,MECHANICAL ENGINEERING,103,62,-41
